Id,Label,screen_name,weight,In-Degree,Out-Degree,Degree,Modularity Class,Clustering Coefficient,Eigenvector Centrality
51318201,ServeMuslims,ServeMuslims,1,1,1,2,1,0,5.72E-04
57516099,AbuDujanah,AbuDujanah,1,1,1,2,1,0,5.72E-04
2380333148,waheebalshami,waheebalshami,1,1,0,1,4,0,0.010908848
2151120994,d3b_0,d3b_0,1,4,1,5,4,0.8333333,0.103696894
23330998,hxhassan,hxhassan,1,0,3,3,4,0.8333333,0
2425258317,AJundul,AJundul,1,1,0,1,4,0,0.010908848
2410709344,AbuRayanMuhajir,AbuRayanMuhajir,1,2,7,9,4,0.54761904,0.043853294
1194295681,sabranyanafsi3,sabranyanafsi3,1,2,0,2,4,0,0.035619863
2794160596,AadilIbnSy,AadilIbnSy,1,5,0,5,4,0.55,0.147298159
14942730,raffpantucci,raffpantucci,1,4,1,5,4,0.8333333,0.143527913
2320794146,R76315,R76315,1,5,0,5,4,0.7,0.168238927
2765892374,abdirahmana70,abdirahmana70,1,2,0,2,4,1,0.0598436
1943929622,Newsistan,Newsistan,1,1,0,1,4,0,0.010908848
48956231,zaidbenjamin,zaidbenjamin,1,1,4,5,4,0.6666667,0.024711015
2596537351,0AbuRuqayyah0,0AbuRuqayyah0,1,5,0,5,4,0.7,0.145309035
2269479971,HalimKakon,HalimKakon,1,5,0,5,4,0.65,0.129765877
2821620829,AbuSumayyah507,AbuSumayyah507,1,2,0,2,4,0.5,0.044300441
2223146256,IslamicFront_En,IslamicFront_En,1,0,4,4,4,0.6666667,0
2221671723,sami10666428,sami10666428,1,4,0,4,4,0.8333333,0.103696894
1452246433,YacineAlBachir,YacineAlBachir,1,3,0,3,4,0.8333333,0.071663268
2567505337,abja78,abja78,1,0,4,4,4,0.8333333,0
2659091942,whiteminaret,whiteminaret,1,4,0,4,4,0.5,0.119304176
1192035883,AbuCeEs,AbuCeEs,1,6,0,6,4,0.73333335,0.178700628
2419820100,umralmahdi,umralmahdi,1,2,0,2,4,0.5,0.044300441
546178630,Jihadology_Net,Jihadology_Net,1,0,6,6,4,0.6,0
2486404732,abdulqahhar114,abdulqahhar114,1,3,0,3,4,0.33333334,0.025140795
2663057024,obaidmirza127,obaidmirza127,1,3,0,3,4,0.6666667,0.094593161
2501707438,green_bird14,green_bird14,1,6,3,9,4,0.73333335,0.178700628
39716568,dominos_pizzafr,dominos_pizzafr,1,0,1,1,4,0,0
2369226460,noemaiql,noemaiql,1,1,0,1,4,0,0.010908848
606767056,Altarefe_En,Altarefe_En,1,0,5,5,4,0.85,0
344328154,parwizahmadi,parwizahmadi,1,6,0,6,4,0.6,0.15775986
219580509,scribblerer,scribblerer,1,1,0,1,4,0,0.010908848
1654309236,AsadulPakistani,AsadulPakistani,1,2,3,5,4,0.8333333,0.044300441
2592934170,1234KHARLAR,1234KHARLAR,1,8,0,8,4,0.44642857,0.19329699
2386299238,qatammi,qatammi,1,2,2,4,4,0.5,0.044300441
2183530871,anterAzra,anterAzra,1,6,1,7,4,0.43333334,0.118293256
2577318295,fawazluxes,fawazluxes,1,1,0,1,4,0,0.010908848
1354238358,Bint_Abiee,Bint_Abiee,1,5,2,7,4,0.7,0.145309035
1797720565,CdricLabrousse,CdricLabrousse,1,0,2,2,4,0.5,0
703072883,loerdag,loerdag,1,1,0,1,4,0,0.010908848
513116847,Abu_Baraa1,Abu_Baraa1,1,0,4,4,4,0.41666666,0
2731491812,AbuHarith_FS,AbuHarith_FS,1,3,0,3,4,0.8333333,0.093235193
2526579548,alKutlawi,alKutlawi,1,3,4,7,4,0.73333335,0.084107467
2543225743,qulhumdulillah,qulhumdulillah,1,2,6,8,4,0.6,0.043853294
2503052231,abu_jihad187,abu_jihad187,1,5,1,6,4,0.85,0.153989613
2785012907,kohinoor133,kohinoor133,1,2,0,2,4,0.5,0.044300441
2201062578,IslamicObserver,IslamicObserver,1,5,0,5,4,0.7,0.128407909
75009219,mssiraj,mssiraj,1,2,0,2,4,1,0.0598436
2250902733,Hamdaan_muhajir,Hamdaan_muhajir,1,2,0,2,4,1,0.021370549
2585586898,enesbagci16,enesbagci16,1,6,0,6,4,0.5,0.132178155
316477171,EhmedHucein,EhmedHucein,1,5,0,5,4,0.85,0.153989613
825266010,Albakistani_JN,Albakistani_JN,1,0,1,1,4,0,0
2826038597,3a9ib,3a9ib,1,3,0,3,4,0.8333333,0.110136319
261656484,Tarek435,Tarek435,1,2,0,2,4,1,0.0598436
2663026669,alnusra313,alnusra313,1,1,2,3,4,0.33333334,0.024711015
2370473975,xinxaro1111,xinxaro1111,1,3,0,3,4,0.8333333,0.054762142
517607551,joaska_,joaska_,1,2,2,4,4,0.8333333,0.0598436
2478772375,abu_ubaydah57,abu_ubaydah57,1,2,0,2,4,0.5,0.044300441
2389741728,Abu_Maryamm,Abu_Maryamm,1,3,0,3,4,0,0.046445979
2783538555,SoldierMerciful,SoldierMerciful,1,2,2,4,4,0.33333334,0.035619863
2279215346,Ma87Mir,Ma87Mir,1,3,0,3,4,0.8333333,0.054762142
2561052932,JHUFeng,JHUFeng,1,0,3,3,4,0.6666667,0
1539215677,JrZulpika,JrZulpika,1,3,0,3,4,0.8333333,0.054762142
2573341045,drgwvr,drgwvr,1,4,0,4,4,0.41666666,0.09538073
2685540421,hasmith7417,hasmith7417,1,6,0,6,4,0.73333335,0.178700628
2574946785,mustafaghurabah,mustafaghurabah,1,6,0,6,4,0.5,0.132178155
2414940649,Truth_ISIS,Truth_ISIS,1,2,4,6,4,0.85,0.043853294
210997813,ajaltamimi,ajaltamimi,1,3,6,9,4,0.73333335,0.092788046
893325943,ansaralhaqq,ansaralhaqq,1,4,1,5,4,0.8333333,0.105054862
1192204400,Elten5,Elten5,1,5,0,5,4,0.85,0.153989613
176525988,yasmine_rc,yasmine_rc,1,4,0,4,4,0.8333333,0.103696894
2254410445,PureMonotheist,PureMonotheist,1,5,1,6,4,0.65,0.129765877
1696961312,RobSterEHW,RobSterEHW,1,1,0,1,4,0,0.010908848
1037308758,altarefe_urdu,altarefe_urdu,1,0,1,1,4,0,0
296981376,Taimiyyah,Taimiyyah,1,5,5,10,4,0.73333335,0.129765877
2775585743,EBUYASR1,EBUYASR1,1,1,0,1,4,0,0.010908848
2373686347,gotoshaam,gotoshaam,1,1,1,2,4,0,0.010908848
524489828,thadiusB1,thadiusB1,1,2,0,2,4,1,0.0598436
2497778816,yellow_turban,yellow_turban,1,1,1,2,4,0,0.010908848
91952367,adilsum,adilsum,1,2,0,2,4,0.5,0.061201568
2759792127,van_zug,van_zug,1,5,0,5,4,0.35,0.090299273
2271680060,DrGS51638623,DrGS51638623,1,3,0,3,4,0.6666667,0.084554614
2807731776,IbnAbdisatar,IbnAbdisatar,1,1,0,1,4,0,0.010908848
2696877912,kokicharo654,kokicharo654,1,1,0,1,4,0,0.010908848
1459099585,3_worldwar,3_worldwar,1,3,0,3,4,0.6666667,0.094593161
2795149271,ObserverMiddle,ObserverMiddle,1,5,4,9,4,0.73333335,0.128407909
2260506595,sebiluna_jihad,sebiluna_jihad,1,1,0,1,4,0,0.010908848
82155524,stefan_schocher,stefan_schocher,1,4,0,4,4,0.5,0.097005439
2836093293,JMutarjim,JMutarjim,1,8,0,8,4,0.44642857,0.19329699
1149573290,ludi_drogba,ludi_drogba,1,3,0,3,4,0.8333333,0.054762142
2245105837,Al_Mudhnib,Al_Mudhnib,1,2,0,2,4,1,0.021370549
2229770429,Umm_shaheed1,Umm_shaheed1,1,6,0,6,4,0.36666667,0.109612677
845453587,benami92,benami92,1,2,0,2,4,0.5,0.044300441
2616170900,afiyashaheen,afiyashaheen,1,5,0,5,4,0.4,0.107831555
941529600,ZeroualR,ZeroualR,1,6,0,6,4,0.5,0.132178155
2548570687,SlaveofAhadd,SlaveofAhadd,1,3,0,3,4,0.8333333,0.071663268
49289813,ferozghachi,ferozghachi,1,3,0,3,4,0.5,0.063613846
2608536206,AbuSayyaaf,AbuSayyaaf,1,1,0,1,4,0,0.010908848
1148951203,SWildlifepics,SWildlifepics,1,0,1,1,4,0,0
2838567620,s7bhijratain3,s7bhijratain3,1,4,5,9,4,0.73333335,0.079473157
54467421,alyrashyd,alyrashyd,1,2,0,2,4,0.5,0.044300441
2451676189,_UmmAbdAllah,_UmmAbdAllah,1,3,0,3,4,0.33333334,0.069011456
2253462690,dota_shiya,dota_shiya,1,1,0,1,4,0,0.010908848
2790235583,muratsawass,muratsawass,1,6,0,6,4,0.73333335,0.178700628
2726927812,hasan_shakour,hasan_shakour,1,1,0,1,4,0,0.010908848
951393817,FranzFeyder,FranzFeyder,1,5,0,5,4,0.4,0.107831555
224206388,Abu_Naoufal,Abu_Naoufal,1,6,0,6,4,0.36666667,0.109612677
2772016744,Amiralmujahida,Amiralmujahida,1,5,2,7,4,0.65,0.129765877
2426378857,daishsupporter,daishsupporter,1,3,0,3,4,0.8333333,0.0703053
2423299732,SaqrAnsaar,SaqrAnsaar,1,5,6,11,4,0.73333335,0.128407909
1581588180,thC4t,thC4t,1,3,0,3,4,0.33333334,0.069011456
2262867787,AbuYahya29,AbuYahya29,1,1,2,3,4,0.5,0.05029272
1388257178,bruun85,bruun85,1,5,1,6,4,0.73333335,0.129765877
64462760,shamym1158,shamym1158,1,3,0,3,4,0.5,0.046081563
2284658684,schirantz,schirantz,1,3,0,3,4,0.33333334,0.069011456
2637406371,jeelanbaad,jeelanbaad,1,2,0,2,4,1,0.021370549
428318892,masoodnejrab,masoodnejrab,1,7,0,7,4,0.54761904,0.182470874
2596577460,omaralgrara,omaralgrara,1,1,0,1,4,0,0.010908848
2649727383,Hafisabidrees,Hafisabidrees,1,3,0,3,4,0.8333333,0.054762142
2287903182,siddik_kaka,siddik_kaka,1,2,0,2,4,0.5,0.044300441
460464868,gixxermangixxer,gixxermangixxer,1,3,2,5,4,0.8333333,0.054762142
2607817538,AL_QAAQA,AL_QAAQA,1,1,0,1,4,0,0.010908848
2785321876,alQorsi,alQorsi,1,2,0,2,4,0.5,0.044300441
2815045800,Shamishams123,Shamishams123,1,5,0,5,4,0.7,0.168238927
2731451381,anasswrimshi,anasswrimshi,1,3,0,3,4,0.33333334,0.069011456
2604019884,AbuISA89,AbuISA89,1,4,2,6,4,0.8333333,0.103696894
469509327,Charles_Lister,Charles_Lister,1,5,6,11,4,0.73333335,0.128407909
2207524123,Bint_Shaheed,Bint_Shaheed,1,5,1,6,4,0.65,0.129765877
2650744172,eefitzgerald93,eefitzgerald93,1,1,0,1,4,0,0.010908848
2256020916,rhchayan,rhchayan,1,2,0,2,4,1,0.0598436
792372662,Pak_witness,Pak_witness,1,5,3,8,4,0.73333335,0.128407909
1678812660,mobrmg,mobrmg,1,1,0,1,4,0,0.010908848
119350852,chloehadj,chloehadj,1,2,0,2,4,0.5,0.044300441
949364370,siddiqesmart,siddiqesmart,1,4,0,4,4,0.6666667,0.095016315
2800658100,getcluedon1,getcluedon1,1,6,0,6,4,0.36666667,0.109612677
2501813965,fahimzauwad,fahimzauwad,1,2,1,3,4,1,0.0598436
1529620189,shaaxibrahim,shaaxibrahim,1,2,0,2,4,0.5,0.044300441
2728765282,IBounanaa_013,IBounanaa_013,1,4,0,4,4,0.5,0.119304176
340371304,Eilas1,Eilas1,1,4,0,4,4,0.8333333,0.103696894
2520491881,ShurdatulSharia,ShurdatulSharia,1,0,1,1,4,0,0
2638522282,abusaifallah200,abusaifallah200,1,4,2,6,4,0.8333333,0.103696894
2779031503,Bdawgsmom2002,Bdawgsmom2002,1,4,0,4,4,0.5,0.074075547
2779195373,ISISgermany,ISISgermany,1,1,0,1,4,0,0.010908848
2284529658,JStartr,JStartr,1,0,1,1,4,0,0
2728536063,amriramzi7,amriramzi7,1,1,0,1,4,0,0.010908848
718612494,princekhattab,princekhattab,1,1,0,1,4,0,0.010908848
2400889028,0rangdepok,0rangdepok,1,6,0,6,4,0.73333335,0.178700628
2663131345,abudawudabdulla,abudawudabdulla,1,3,0,3,4,0.33333334,0.069011456
2598021350,AbuNussayba,AbuNussayba,1,1,0,1,4,0,0.010908848
2426775870,aswj1234,aswj1234,1,4,0,4,4,0.5,0.119304176
2740169068,M3Iraq,M3Iraq,1,4,0,4,4,0.41666666,0.08832486
2809473452,AboMusabAlSuri,AboMusabAlSuri,1,0,1,1,4,0,0
1413360120,KrismedinaKm,KrismedinaKm,1,2,0,2,4,0.5,0.044300441
2683218476,tu_wor,tu_wor,1,3,0,3,4,0.16666667,0.048070688
213723734,anonymous_u1,anonymous_u1,1,4,1,5,4,0.8333333,0.103696894
1823189756,intelMujahid,intelMujahid,1,0,1,1,4,0,0
862333693,tweetdoug45,tweetdoug45,1,3,0,3,4,0.8333333,0.054762142
433171491,faisshah,faisshah,1,4,0,4,4,0.5833333,0.079473157
2695933065,mozairkhan,mozairkhan,1,2,0,2,4,0.5,0.044300441
2754391411,muwahideenmedia,muwahideenmedia,1,5,4,9,4,0.7,0.168238927
1486937328,ibn_latief,ibn_latief,1,6,1,7,4,0.5,0.132178155
2658250200,vdagestanEn,vdagestanEn,1,0,1,1,4,0,0
703049205,Battalinbabas1,Battalinbabas1,1,5,0,5,4,0.5,0.108825108
2491198986,abu_ubaydah333,abu_ubaydah333,1,5,3,8,4,0.73333335,0.128407909
2423926546,abukhawlamjr,abukhawlamjr,1,6,3,9,4,0.73333335,0.178700628
2670899040,QatadahAbu,QatadahAbu,1,5,0,5,4,0.7,0.128407909
2748690320,JunudS,JunudS,1,0,4,4,4,0.8333333,0
2527211514,MansurAbuSayf,MansurAbuSayf,1,6,3,9,4,0.73333335,0.178700628
2797744178,911tripple000,911tripple000,1,2,0,2,4,1,0.0598436
2248781900,AbdulhadiHamad1,AbdulhadiHamad1,1,1,0,1,4,0,0.010908848
33534356,ysfsuleman,ysfsuleman,1,5,0,5,4,0.55,0.147298159
2638760018,tabaddadat,tabaddadat,1,2,0,2,4,0.5,0.061201568
2649600495,soennah_dokter,soennah_dokter,1,2,0,2,4,1,0.0598436
2585670284,alharbiF161,alharbiF161,1,3,0,3,4,0.8333333,0.054762142
1318269660,samadmohamad11,samadmohamad11,1,4,0,4,4,0.8333333,0.103696894
2676110376,ISISwitness,ISISwitness,1,5,3,8,4,0.65,0.129765877
518730830,FlashpointIntel,FlashpointIntel,1,0,3,3,4,0.6666667,0
459814000,Ummah_Today,Ummah_Today,1,3,2,5,4,0.6666667,0.094593161
2636232215,newtweeter012,newtweeter012,1,2,0,2,4,1,0.0598436
2851583545,Mohammadibra78,Mohammadibra78,1,2,0,2,4,0,0.035619863
2677028553,EbuBilalElKurDi,EbuBilalElKurDi,1,3,0,3,4,0.8333333,0.093235193
2593863547,DrEyadQunaibi,DrEyadQunaibi,1,0,6,6,4,0.73333335,0
2819536949,Abdulhaqq092,Abdulhaqq092,1,5,0,5,4,0.55,0.11452301
2359670881,ibn_zia,ibn_zia,1,1,0,1,4,0,0.010908848
91207854,Ndeshkuesi,Ndeshkuesi,1,4,0,4,4,0.5,0.104061309
2489006616,ar_rumi03,ar_rumi03,1,1,0,1,4,0,0.010908848
263993954,2BFreeMe,2BFreeMe,1,3,0,3,4,0.8333333,0.0703053
532700952,EYADQUNAIBI,EYADQUNAIBI,1,0,4,4,4,0.6666667,0
2501511626,afghanistan_dp,afghanistan_dp,1,1,0,1,4,0,0.010908848
2294725468,AfghaniWitness,AfghaniWitness,1,1,3,4,4,0.8333333,0.010908848
141540326,FirdausRayazid,FirdausRayazid,1,4,0,4,4,0.8333333,0.103696894
2354330932,htcRaja,htcRaja,1,3,0,3,4,0.8333333,0.054762142
2398043448,IbnNabih,IbnNabih,1,3,6,9,4,0.73333335,0.068564309
1558396322,nyelokjail,nyelokjail,1,2,0,2,4,1,0.0598436
2766192110,AlAldawa,AlAldawa,1,1,0,1,4,0,0.010908848
2714582606,AkibintMiah,AkibintMiah,1,3,0,3,4,0.8333333,0.093235193
1604173412,AbDujanah,AbDujanah,1,5,6,11,4,0.73333335,0.129765877
2227945081,MarkazAlHayaat,MarkazAlHayaat,1,4,4,8,4,0.8333333,0.103696894
2611003062,e_anfal,e_anfal,1,1,0,1,4,0,0.010908848
2686566116,roohafza1990,roohafza1990,1,3,0,3,4,0.8333333,0.093235193
2308038631,Hafiz_Zohib,Hafiz_Zohib,1,6,3,9,4,0.73333335,0.178700628
110641026,suhailovaise,suhailovaise,1,1,0,1,4,0,0.010908848
157302681,biggnishan,biggnishan,1,2,0,2,4,0.5,0.044300441
247653244,muftimenk,muftimenk,1,0,3,3,4,0.8333333,0
390447335,Povikkonvistina,Povikkonvistina,1,2,0,2,4,0.5,0.044300441
590692592,JavadBhat,JavadBhat,1,4,0,4,4,0.8333333,0.103696894
2371469767,statesman786,statesman786,1,1,0,1,4,0,0.010908848
2633843184,AbouQaqa,AbouQaqa,1,3,0,3,4,0.8333333,0.071663268
2472264264,AslimTaslam00,AslimTaslam00,1,3,0,3,4,0.5,0.046081563
966476652,MullahNasrudeen,MullahNasrudeen,1,5,0,5,4,0.65,0.129765877
1675805642,vasosac,vasosac,1,1,0,1,4,0,0.010908848
2687091670,han_nika,han_nika,1,3,0,3,4,0.6666667,0.084554614
2419389946,broeskimo,broeskimo,1,1,0,1,4,0,0.010908848
2614019072,junaidhaider334,junaidhaider334,1,1,0,1,4,0,0.010908848
2590065757,mohdsnosra,mohdsnosra,1,3,1,4,4,0.6666667,0.094593161
2201535764,AnotherMuhaajir,AnotherMuhaajir,1,0,5,5,4,0.7,0
2488485355,MuhhamadAtta,MuhhamadAtta,1,4,0,4,4,0.5833333,0.079473157
2431993324,NovaStara,NovaStara,1,4,0,4,4,0.8333333,0.103696894
2607138396,DhulQarnayn1988,DhulQarnayn1988,1,2,1,3,4,0.8333333,0.021370549
2299512561,jab2victory,jab2victory,1,84,359,443,4,0.005304652,0.232750945
26887974,smalik68,smalik68,1,4,0,4,4,0.8333333,0.143527913
2633647914,wheepshakr,wheepshakr,1,4,0,4,4,0.8333333,0.103696894
2322909205,farooq_drishak,farooq_drishak,1,1,0,1,4,0,0.010908848
2396637280,GlobalJihadi,GlobalJihadi,1,2,0,2,4,0.5,0.044300441
2326055011,aboosama57618,aboosama57618,1,1,0,1,4,0,0.010908848
2293876986,aaboodi830,aaboodi830,1,3,1,4,4,0.8333333,0.054762142
2374387981,c21042011,c21042011,1,5,0,5,4,0.55,0.11452301
81578409,sv71x,sv71x,1,3,0,3,4,0.8333333,0.093235193
2305345980,AdamAlmaqusi,AdamAlmaqusi,1,1,0,1,4,0,0.010908848
2507229865,abu_wahib313,abu_wahib313,1,4,0,4,4,0.5,0.074075547
2817215300,moraselallEN,moraselallEN,1,0,4,4,4,0.6666667,0
2628307844,hawzir191,hawzir191,1,3,0,3,4,0.6666667,0.094593161
2732215313,ahmedcisse102,ahmedcisse102,1,2,0,2,4,1,0.021370549
2371734582,JabhatAlNusraEN,JabhatAlNusraEN,1,0,5,5,4,0.7,0
2373766202,Muslim_Bakistan,Muslim_Bakistan,1,2,0,2,4,0.5,0.044300441
2684980408,UmmBaraa_aq,UmmBaraa_aq,1,4,2,6,4,0.8333333,0.103696894
2282573028,xhango_,xhango_,1,4,0,4,4,0.8333333,0.103696894
2620280208,abuw_ukasyah,abuw_ukasyah,1,6,1,7,4,0.73333335,0.178700628
1918269350,abuayubmuhammad,abuayubmuhammad,1,4,4,8,4,0.7,0.119304176
2765704692,harith213,harith213,1,4,0,4,4,0.8333333,0.143527913
2777632248,musaharun90,musaharun90,1,5,0,5,4,0.7,0.145309035
2759773772,jistaniyya,jistaniyya,1,2,0,2,4,0,0.014679094
2601733722,_HamzaBC,_HamzaBC,1,5,1,6,4,0.65,0.129765877
1627016881,omarshehidi,omarshehidi,1,2,0,2,4,0.5,0.061201568
83775159,islamqa_en,islamqa_en,1,0,3,3,4,0.8333333,0
2564214475,y1234h58,y1234h58,1,1,0,1,4,0,0.010908848
276451060,FARHAAN79,FARHAAN79,1,3,0,3,4,0.5,0.063613846
1606242174,charliewinter,charliewinter,1,4,0,4,4,0.16666667,0.072781702
2816888745,AAlqorsi,AAlqorsi,1,2,0,2,4,0.5,0.044300441
2164280667,IbnJarrah,IbnJarrah,1,2,0,2,4,0,0.035619863
2284081312,ummmuthannah77,ummmuthannah77,1,7,1,8,4,0.54761904,0.182470874
2764525756,a2756830d1e847c,a2756830d1e847c,1,5,1,6,4,0.7,0.168238927
106058082,FabianAmjad,FabianAmjad,1,3,0,3,4,0.8333333,0.093235193
1526125291,Abu_ubaydillah,Abu_ubaydillah,1,1,0,1,4,0,0.010908848
2490356868,AbuAafiaDhirar,AbuAafiaDhirar,1,1,0,1,4,0,0.010908848
2609042591,xinxaro111,xinxaro111,1,7,1,8,4,0.4047619,0.143004271
2822395050,BintSaalih,BintSaalih,1,2,0,2,4,0.5,0.044300441
2582172858,abou_oussema,abou_oussema,1,2,0,2,4,1,0.021370549
2453722299,jihadwartracker,jihadwartracker,1,2,0,2,4,0,0.021734964
1597560036,ShamCenterINFO,ShamCenterINFO,1,0,1,1,4,0,0
2398315394,Abushaheed619,Abushaheed619,1,4,0,4,4,0.5833333,0.079473157
845272507,HassanAlBasri50,HassanAlBasri50,1,3,0,3,4,0.8333333,0.054762142
2826262028,seyhyavuz,seyhyavuz,1,1,0,1,4,0,0.010908848
37654161,prashaanb,prashaanb,1,1,0,1,4,0,0.010908848
311383932,Adiwirawann,Adiwirawann,1,6,1,7,4,0.73333335,0.178700628
2167462081,salaam1022,salaam1022,1,3,0,3,4,0.5,0.046081563
1326911210,KZiggy,KZiggy,1,3,0,3,4,0.33333334,0.069011456
283630254,johnnymotorbike,johnnymotorbike,1,0,2,2,4,0.5,0
2443568251,abumohammad25,abumohammad25,1,1,0,1,4,0,0.010908848
2557271100,S_O_Dawn,S_O_Dawn,1,0,6,6,4,0.73333335,0
77225131,SalimIbnAdam,SalimIbnAdam,1,4,0,4,4,0.6666667,0.117946208
2278448310,Abi_Maysarah,Abi_Maysarah,1,1,4,5,4,0.5,0.024711015
325967034,MimisWish,MimisWish,1,3,0,3,4,0.8333333,0.093235193
2736905539,Abu_Abdullah_IS,Abu_Abdullah_IS,1,4,0,4,4,0.8333333,0.103696894
1668341100,AbuHodayfa,AbuHodayfa,1,1,1,2,4,1,0.010461701
2415714109,RetweetShaam,RetweetShaam,1,6,3,9,4,0.73333335,0.178700628
2423371248,KhorasanWitness,KhorasanWitness,1,1,5,6,4,0.7,0.024711015
2739757220,whoisISIS,whoisISIS,1,0,2,2,4,0,0
2272420088,Noorarahman,Noorarahman,1,3,1,4,4,0.8333333,0.093235193
313942370,playerz_rulz,playerz_rulz,1,4,0,4,4,0.6666667,0.117946208
2719965830,Akhtar01Akhtar,Akhtar01Akhtar,1,3,0,3,4,0.8333333,0.071663268
2815419046,news__follower1,news__follower1,1,4,0,4,4,0.41666666,0.09538073
2713084618,AbuYahya73,AbuYahya73,1,1,0,1,4,0,0.010908848
2394607737,AbuMuslim860,AbuMuslim860,1,4,1,5,4,0.8333333,0.103696894
780657446,ahmedayash3,ahmedayash3,1,1,0,1,4,0,0.010908848
2414928764,KalhuZakariya,KalhuZakariya,1,4,0,4,4,0.5,0.104061309
936240626,usamani1,usamani1,1,5,1,6,4,0.55,0.10746714
390685616,xsinnux,xsinnux,1,3,0,3,4,0.8333333,0.054762142
2160321668,MuslimAfghani,MuslimAfghani,1,2,0,2,4,0.5,0.044300441
2775934104,ihyaekhilafat1,ihyaekhilafat1,1,2,1,3,4,0.8333333,0.0598436
2796414154,LifeofMujahid1,LifeofMujahid1,1,7,5,12,4,0.44642857,0.168585976
2328716599,bolansang,bolansang,1,5,0,5,4,0.55,0.10746714
2604950900,Blackhawk21974,Blackhawk21974,1,3,0,3,4,0.8333333,0.093235193
2595349922,AbouHourayra2,AbouHourayra2,1,5,4,9,4,0.73333335,0.129765877
2343134834,BiladAlSham_Dhi,BiladAlSham_Dhi,1,6,5,11,4,0.73333335,0.178700628
2665047948,biqasim,biqasim,1,4,1,5,4,0.8333333,0.143527913
210757543,Jaynabzz,Jaynabzz,1,1,1,2,4,0,0.010908848
2265835528,a11112784,a11112784,1,2,0,2,4,1,0.021370549
2565531673,AzzamElbahry,AzzamElbahry,1,5,0,5,4,0.7,0.128407909
2801952808,aliceberguer,aliceberguer,1,3,0,3,4,0.16666667,0.048070688
2406443139,AhmedMdilshad,AhmedMdilshad,1,3,0,3,4,0.6666667,0.084554614
2830428372,AbuMuhMagr,AbuMuhMagr,1,2,0,2,4,0.5,0.044300441
2647124575,aljabeer07,aljabeer07,1,4,0,4,4,0.6666667,0.117946208
2356931285,Saifullah0123,Saifullah0123,1,2,1,3,4,1,0.021370549
1529003149,ADLFreeSyriaSA,ADLFreeSyriaSA,1,3,0,3,4,0.33333334,0.069011456
2724916048,EmadRoni,EmadRoni,1,4,0,4,4,0.8333333,0.103696894
1923312468,Muddathir5,Muddathir5,1,4,2,6,4,0.8333333,0.103696894
2769480687,AboeGhaza,AboeGhaza,1,3,0,3,4,0.8333333,0.093235193
2599152667,shahmohsin308,shahmohsin308,1,3,0,3,4,0.8333333,0.071663268
49638458,LoriBHinde,LoriBHinde,1,6,0,6,4,0.6,0.15775986
2799398041,Aubrngdss,Aubrngdss,1,5,0,5,4,0.45,0.105842431
2149641426,bu_hussain_hind,bu_hussain_hind,1,4,0,4,4,0.8333333,0.103696894
2445340009,Shaho_Rezai,Shaho_Rezai,1,1,0,1,4,0,0.010908848
2198204024,65ahi_ibrahim,65ahi_ibrahim,1,1,0,1,4,0,0.010908848
435646089,RubenBurgosxD,RubenBurgosxD,1,3,0,3,4,0.8333333,0.0703053
2824793751,AMombasi,AMombasi,1,5,0,5,4,0.7,0.128407909
736980782,Ayetullah12,Ayetullah12,1,5,0,5,4,0.35,0.083243403
2370989890,Jornie99,Jornie99,1,3,0,3,4,0.33333334,0.025140795
292483236,AbuEissaa7,AbuEissaa7,1,6,0,6,4,0.5,0.132178155
2392977619,IbnRandom,IbnRandom,1,2,0,2,4,1,0.021370549
608399764,ja3far45,ja3far45,1,2,2,4,4,0.5833333,0.021370549
2802086340,Polder_Mujahid,Polder_Mujahid,1,2,0,2,4,0.5,0.044300441
2726556107,getcluedon,getcluedon,1,1,0,1,4,0,0.010908848
2452287955,amir20008,amir20008,1,4,0,4,4,0.16666667,0.072781702
2611180139,JunudAlRahmn_EN,JunudAlRahmn_EN,1,0,1,1,4,0,0
403272315,hussnainali17,hussnainali17,1,4,0,4,4,0.5,0.119304176
2462937736,saraqeb1990,saraqeb1990,1,1,0,1,4,0,0.010908848
105411216,BilalKareem,BilalKareem,1,0,4,4,4,0.8333333,0
2321052450,J_Eielamiya,J_Eielamiya,1,0,2,2,4,0.5,0
2392101718,agim_murati,agim_murati,1,2,0,2,4,0.5,0.061201568
2601317388,Althalib212,Althalib212,1,2,0,2,4,0.5,0.044300441
2575660232,gaffurcabbar,gaffurcabbar,1,3,0,3,4,0.33333334,0.025140795
2783573216,abuzuba1r,abuzuba1r,1,5,0,5,4,0.85,0.153989613
2351920436,Sandzaki,Sandzaki,1,6,0,6,4,0.73333335,0.178700628
1376253259,Cheale41Heale,Cheale41Heale,1,3,0,3,4,0.8333333,0.0703053
612389773,miqbal178,miqbal178,1,6,0,6,4,0.5,0.139234024
64550326,amna1suki,amna1suki,1,4,0,4,4,0.8333333,0.103696894
2561963637,617172dbc52f46a,617172dbc52f46a,1,5,0,5,4,0.65,0.129765877
2718005052,abuturab001,abuturab001,1,3,1,4,4,0.6666667,0.094593161
2787735365,212Abu3boud,212Abu3boud,1,2,0,2,4,0.5,0.044300441
1081964588,ibnnasrabdullah,ibnnasrabdullah,1,1,0,1,4,0,0.010908848
736056330,nafeesibnum,nafeesibnum,1,5,0,5,4,0.7,0.128407909
1909680492,Abul_Qaqa,Abul_Qaqa,1,5,3,8,4,0.55,0.124368266
2348873912,me2455,me2455,1,5,0,5,4,0.35,0.100144529
147519872,CheerLeadUnited,CheerLeadUnited,1,5,3,8,4,0.65,0.129765877
2641557928,Ghurabah1,Ghurabah1,1,1,0,1,4,0,0.010908848
2814344970,AbuSyrie,AbuSyrie,1,6,0,6,4,0.36666667,0.13254257
1899952826,LetteredOwl,LetteredOwl,1,4,0,4,4,0.5833333,0.079473157
965114592,mmorgi,mmorgi,1,1,0,1,4,0,0.010908848
2159508373,ABUelBARA2,ABUelBARA2,1,3,0,3,4,0.8333333,0.054762142
2371615662,truth_supporte1,truth_supporte1,1,1,1,2,4,0,0.010908848
2790587312,JihadMatchmaker,JihadMatchmaker,1,6,1,7,4,0.6,0.15775986
1715502036,hawwaad,hawwaad,1,1,0,1,4,0,0.010908848
230194175,ana_jubair,ana_jubair,1,2,0,2,4,1,0.0598436
1185315906,pretorian1972,pretorian1972,1,1,0,1,4,0,0.010908848
2591128939,766820074,766820074,1,4,0,4,4,0.8333333,0.105054862
2812870089,karimabdalla90,karimabdalla90,1,1,0,1,4,0,0.010908848
2403139019,Muhajir_Shaam,Muhajir_Shaam,1,3,4,7,4,0.85,0.054762142
361804529,sambaceesay,sambaceesay,1,4,0,4,4,0.5,0.097005439
2722364899,PeshmergaF,PeshmergaF,1,3,0,3,4,0.8333333,0.093235193
123698661,Azam36,Azam36,1,1,0,1,4,0,0.010908848
2834857568,umerkhattab1987,umerkhattab1987,1,2,0,2,4,1,0.0598436
2457501372,AuthenticTauhed,AuthenticTauhed,1,0,1,1,4,0,0
2726428382,ClarissaAnn5,ClarissaAnn5,1,1,0,1,4,0,0.010908848
128679723,ScentedBlood,ScentedBlood,1,1,1,2,4,1,0.010461701
1872756613,MuwahhidMedia,MuwahhidMedia,1,0,4,4,4,0.8333333,0
2775777225,GunsandCoffee19,GunsandCoffee19,1,3,0,3,4,0.33333334,0.069011456
2154463262,aboalbaraa0,aboalbaraa0,1,0,1,1,8,0,0
1920073766,jihadbook,jihadbook,1,1,0,1,8,0,0.05029272
2533556276,alg_had,alg_had,1,0,1,1,8,0,0
1630896181,vicenews,vicenews,1,0,1,1,8,0,0
50593853,Firdoors,Firdoors,1,1,0,1,8,0,0.05029272
88440926,Moazzam_Begg,Moazzam_Begg,1,1,2,3,8,0.5,0.024711015
156598479,Khuraasani,Khuraasani,1,0,1,1,8,0,0
1536300415,Sirdiofadofa,Sirdiofadofa,1,1,0,1,8,0,0.05029272
22741371,THE_47th,THE_47th,1,0,1,1,8,0,0
2802483587,AbuDujanah_,AbuDujanah_,1,3,0,3,8,1,0.094146014
1042383266,MinbarAnsar,MinbarAnsar,1,0,1,1,8,0,0
1245577638,Ansarshare3a,Ansarshare3a,1,0,1,1,8,0,0
776028235,ALseaase,ALseaase,1,0,2,2,8,0.5,0
1640169925,CasillasWorld,CasillasWorld,1,0,1,1,8,0,0
84083187,OzKaterji,OzKaterji,1,2,1,3,8,0.33333334,0.014231947
2788229657,Abuuzubeeyr,Abuuzubeeyr,1,2,0,2,8,1,0.06075442
1096909404,1800422,1800422,1,0,2,2,8,0.5,0
632881941,ahmad_alaseer,ahmad_alaseer,1,0,2,2,8,1,0
2573108094,mirandaer0,mirandaer0,1,1,0,1,8,0,0.05029272
2720826256,MahirMuhandis,MahirMuhandis,1,1,0,1,8,0,0.05029272
304808873,DrBilalPhilips,DrBilalPhilips,1,0,2,2,8,1,0
1656816554,SpyEyeBot,SpyEyeBot,1,1,0,1,8,0,0.05029272
180519894,BoGo23,BoGo23,1,1,1,2,8,0,0.05029272
36602851,haesham,haesham,1,1,0,1,8,0,0.05029272
87818409,guardian,guardian,1,0,2,2,8,1,0
2602238989,Zalfi11,Zalfi11,1,1,0,1,8,0,0.05029272
1731724314,SunniPrisoners,SunniPrisoners,1,0,1,1,8,0,0
586712104,IAmTassnim,IAmTassnim,1,0,1,1,8,0,0
456361002,jasminechic1,jasminechic1,1,2,1,3,8,0,0.054062966
1902734184,AbuSyamilAlfath,AbuSyamilAlfath,1,1,0,1,8,0,0.05029272
575112328,bankofmaldives,bankofmaldives,1,0,1,1,8,0,0
2797601933,AllNukhba,AllNukhba,1,0,1,1,8,0,0
42501345,BowenBBC,BowenBBC,1,0,1,1,8,0,0
299140349,Lethal_skillz,Lethal_skillz,1,1,0,1,8,0,0.05029272
2815624485,shamlmohands,shamlmohands,1,1,0,1,8,0,0.05029272
223544684,ZeJaeger,ZeJaeger,1,1,2,3,8,0.6666667,0.010461701
261784962,abohasan_1,abohasan_1,1,0,3,3,8,0.8333333,0
2728363432,MardiyyahsFrag,MardiyyahsFrag,1,1,0,1,8,0,0.05029272
2381055428,Deirzoor_Jn,Deirzoor_Jn,1,0,2,2,8,0.5,0
236422628,ReactivatUrHaya,ReactivatUrHaya,1,1,2,3,8,1,0.033391593
395477244,tweetsauce,tweetsauce,1,0,1,1,8,0,0
2841970201,0d445c1d7c53484,0d445c1d7c53484,1,3,0,3,8,0.16666667,0.078773981
138020428,millerC4,millerC4,1,0,1,1,8,0,0
2201880156,ZBIR_G,ZBIR_G,1,0,3,3,8,0.8333333,0
2335016587,JN_Halab,JN_Halab,1,0,3,3,8,0.8333333,0
77694615,anjum_meer,anjum_meer,1,0,1,1,8,0,0
602801866,Alnubala1,Alnubala1,1,0,1,1,8,0,0
2587526879,ForAllahsSake,ForAllahsSake,1,0,1,1,8,0,0
1467975397,UNSOFA1,UNSOFA1,1,0,1,1,8,0,0
506201870,Aikittak1,Aikittak1,1,1,0,1,8,0,0.05029272
316606331,IbmIbrahimKhan,IbmIbrahimKhan,1,1,0,1,8,0,0.05029272
2325940128,SamihaTarin,SamihaTarin,1,1,0,1,8,0,0.05029272
2791049139,idirizhussein,idirizhussein,1,1,0,1,8,0,0.05029272
1423837117,_aabdul,_aabdul,1,0,1,1,8,0,0
620398542,RonaldKoeman,RonaldKoeman,1,0,1,1,8,0,0
609421295,Hijabonita_32,Hijabonita_32,1,1,1,2,8,0,0.05029272
1275103400,asdf1123asdf,asdf1123asdf,1,0,1,1,8,0,0
868649191,Tarekmohmed5,Tarekmohmed5,1,1,0,1,8,0,0.05029272
428333,cnnbrk,cnnbrk,1,0,2,2,8,0,0
45549870,SamayAhadi,SamayAhadi,1,1,1,2,8,1,0.033391593
2592082228,AbuBakrAlSudani,AbuBakrAlSudani,1,0,1,1,8,0,0
1601964374,alhekma2,alhekma2,1,1,0,1,8,0,0.05029272
1373178259,MumenMuwahhed,MumenMuwahhed,1,1,0,1,8,0,0.05029272
294226340,GLEISE581,GLEISE581,1,0,1,1,8,0,0
255986116,markito0171,markito0171,1,0,2,2,8,0.5,0
2425031143,loss_mix,loss_mix,1,1,0,1,8,0,0.05029272
2465630749,rockky36,rockky36,1,3,0,3,8,0.5,0.102997717
582617639,uygaraktas,uygaraktas,1,2,1,3,8,1,0.099227471
2424080940,Jubaadarda,Jubaadarda,1,5,3,8,8,0.8,0.16779178
2828143170,azzambrigades1,azzambrigades1,1,0,1,1,8,0,0
2283833933,hasretcephesi,hasretcephesi,1,0,1,1,8,0,0
383486561,DICS131294,DICS131294,1,1,0,1,8,0,0.05029272
2371127926,al_kofiee,al_kofiee,1,0,1,1,8,0,0
2155711137,AbdulQadir00,AbdulQadir00,1,2,0,2,8,1,0.083684313
370248382,ShiaAlert,ShiaAlert,1,0,1,1,8,0,0
404523750,Abu_Mariya,Abu_Mariya,1,0,1,1,8,0,0
1663470348,1222mmmfk,1222mmmfk,1,0,2,2,8,1,0
154962753,ibnQaim,ibnQaim,1,0,1,1,8,0,0
86248302,abdulbaais,abdulbaais,1,1,0,1,8,0,0.05029272
2658012061,alkhair_news,alkhair_news,1,0,1,1,8,0,0
24382468,borzou,borzou,1,0,1,1,8,0,0
906857514,QalandarTabrizi,QalandarTabrizi,1,0,1,1,8,0,0
2806058045,JnHalab,JnHalab,1,0,2,2,8,0.5,0
231410756,KawkabHussein,KawkabHussein,1,3,0,3,8,0.5,0.102997717
1427934282,sallemuhammed80,sallemuhammed80,1,2,0,2,8,1,0.06075442
606211203,gianluigibuffon,gianluigibuffon,1,0,1,1,8,0,0
387550432,SAfrica2011,SAfrica2011,1,1,1,2,8,1,0.033391593
252153070,naseralomar,naseralomar,1,0,2,2,8,1,0
2284490046,shkeem_2,shkeem_2,1,0,1,1,8,0,0
18189723,jordantimes,jordantimes,1,0,1,1,8,0,0
2795048350,KhalidMaghrebi,KhalidMaghrebi,1,2,3,5,8,0.75,0.035172715
1488489920,TaFaWuT,TaFaWuT,1,1,0,1,8,0,0.05029272
2537655782,fustatmuslemen,fustatmuslemen,1,0,1,1,8,0,0
2157022711,CruelName,CruelName,1,0,1,1,8,0,0
288755234,Brown_Moses,Brown_Moses,1,0,3,3,8,0.8333333,0
631213621,LostIslamicHist,LostIslamicHist,1,0,3,3,8,1,0
776081172,zakiyamoola,zakiyamoola,1,1,0,1,8,0,0.05029272
933138228,AyshaMuhhamed,AyshaMuhhamed,1,1,0,1,8,0,0.05029272
2827423650,aboaicha3,aboaicha3,1,1,0,1,8,0,0.05029272
782503890,zabihmujahid,zabihmujahid,1,0,1,1,8,0,0
1114837016,Mdahsanhabib91,Mdahsanhabib91,1,2,0,2,8,1,0.099227471
17567795,M_Ullah,M_Ullah,1,0,1,1,8,0,0
533205068,abuKhashia,abuKhashia,1,0,1,1,8,0,0
2829947057,Abujandal001,Abujandal001,1,2,0,2,8,0.5,0.075003734
19861701,shk1234,shk1234,1,0,2,2,8,1,0
1089540296,Indyjournalism,Indyjournalism,1,3,0,3,8,0.33333334,0.064524667
2508198116,raIIies_transfi,raIIies_transfi,1,1,0,1,8,0,0.05029272
219255067,MohamadAlarefe,MohamadAlarefe,1,0,2,2,8,1,0
468750659,Loquiita63,Loquiita63,1,0,1,1,8,0,0
29823302,jihadinshallah,jihadinshallah,1,0,1,1,8,0,0
855180008,akh_fuaadh,akh_fuaadh,1,1,2,3,8,1,0.048934752
1470894458,Al_oglaaa,Al_oglaaa,1,0,1,1,8,0,0
606704038,Valthermond0599,Valthermond0599,1,3,0,3,8,1,0.094146014
569446928,joshua_landis,joshua_landis,1,0,2,2,8,1,0
464720451,TweetDawah,TweetDawah,1,0,1,1,8,0,0
135369291,Muadh_Clarke,Muadh_Clarke,1,1,0,1,8,0,0.05029272
1418302134,eyalhaqq4,eyalhaqq4,1,2,0,2,8,1,0.083684313
2292650702,oJjJjJl,oJjJjJl,1,0,1,1,8,0,0
2388038365,EbuMundhir,EbuMundhir,1,5,0,5,8,0.6,0.146851012
2262117851,al__1435,al__1435,1,0,1,1,8,0,0
1066210098,truth121234,truth121234,1,0,1,1,8,0,0
1669501758,Ziyad_AlSuri,Ziyad_AlSuri,1,3,0,3,8,1,0.132619065
2649330505,aldlbe1,aldlbe1,1,0,1,1,8,0,0
873743168,abo_sayaf_,abo_sayaf_,1,0,1,1,8,0,0
2695435153,anasdada95,anasdada95,1,2,0,2,8,1,0.099227471
1678414742,AbuEsseyah,AbuEsseyah,1,0,1,1,8,0,0
2801636261,MuslimEmpire,MuslimEmpire,1,2,0,2,8,1,0.099227471
27005866,razenderamesar,razenderamesar,1,1,1,2,8,1,0.010461701
1437307867,AliAxxarm,AliAxxarm,1,0,1,1,8,0,0
2516839931,KuRTALamdar,KuRTALamdar,1,1,0,1,8,0,0.05029272
108664025,UK_CAGE,UK_CAGE,1,0,1,1,8,0,0
183276772,AhmadJahmal,AhmadJahmal,1,1,0,1,8,0,0.05029272
1673106746,madmadtrk,madmadtrk,1,1,0,1,8,0,0.05029272
458691937,brothermuadh,brothermuadh,1,0,1,1,8,0,0
759251,CNN,CNN,1,0,1,1,8,0,0
769660374,FreeAliT,FreeAliT,1,0,2,2,8,1,0
396858847,BeysehirliSevda,BeysehirliSevda,1,1,0,1,8,0,0.05029272
78419468,Anwar_al_Shamal,Anwar_al_Shamal,1,5,0,5,8,0.8,0.16779178
1731434252,Miirwais,Miirwais,1,0,2,2,8,1,0
2696091411,1987Abas,1987Abas,1,1,0,1,8,0,0.05029272
2782500638,JN_TechArmy,JN_TechArmy,1,0,1,1,8,0,0
2330330082,Pirlo_official,Pirlo_official,1,0,1,1,8,0,0
193304479,freepostingup,freepostingup,1,1,0,1,8,0,0.05029272
445093923,abdullaholandye,abdullaholandye,1,2,0,2,8,1,0.06075442
1941690726,yaman__Islam,yaman__Islam,1,0,1,1,8,0,0
509876336,Alkareemiy,Alkareemiy,1,0,1,1,8,0,0
504961316,kashmaa66,kashmaa66,1,0,1,1,8,0,0
108632411,wellspring2002,wellspring2002,1,1,0,1,8,0,0.05029272
376805797,MousaAlomar,MousaAlomar,1,0,2,2,8,0.5,0
2792364559,DokterMalek,DokterMalek,1,3,0,3,8,0.33333334,0.071580536
365697561,ibnRajab,ibnRajab,1,0,1,1,8,0,0
1024072302,TheIslamApp,TheIslamApp,1,1,0,1,8,0,0.05029272
728308490,BintAbdullah94,BintAbdullah94,1,0,1,1,8,0,0
1551276818,AbHaribo,AbHaribo,1,1,0,1,8,0,0.05029272
862886724,ShaamAlislam,ShaamAlislam,1,0,2,2,8,0.5,0
2795084673,AbuyehyaAlshami,AbuyehyaAlshami,1,3,3,6,8,0.8,0.092788046
162569159,traveller_94,traveller_94,1,1,2,3,8,0.8333333,0.010461701
2827393998,thamer5690,thamer5690,1,0,2,2,8,0.5,0
435297255,Daudoo,Daudoo,1,0,2,2,8,1,0
2399247370,abogaleb17,abogaleb17,1,0,1,1,8,0,0
98475059,aikittak,aikittak,1,1,0,1,8,0,0.05029272
521346204,tankitzbalay,tankitzbalay,1,1,0,1,8,0,0.05029272
607198443,SimNasr,SimNasr,1,1,1,2,8,1,0.033391593
2836176138,abuuusamah,abuuusamah,1,4,0,4,8,0.75,0.118857029
2355010837,anonymousawakes,anonymousawakes,1,4,0,4,8,0.9166667,0.143080765
2760547607,TMonsoora,TMonsoora,1,3,0,3,8,0.8333333,0.109689172
2169740583,TurkWitness,TurkWitness,1,1,2,3,8,0.5,0.024711015
227253576,dahunted786,dahunted786,1,0,1,1,8,0,0
2796881123,1515_bloggs,1515_bloggs,1,2,0,2,8,1,0.099227471
388472234,al_7aleem,al_7aleem,1,0,1,1,8,0,0
411737577,safarAlhawali,safarAlhawali,1,0,1,1,8,0,0
2686951009,DidaZahra,DidaZahra,1,2,0,2,8,0.5,0.075003734
2841517759,ers710eee,ers710eee,1,2,0,2,8,1,0.06075442
963419850,AbuTurabAsqalni,AbuTurabAsqalni,1,3,0,3,8,1,0.132619065
413802217,MuslimsInUSA,MuslimsInUSA,1,1,1,2,8,0,0.05029272
869375761,Muxaffaru,Muxaffaru,1,0,1,1,8,0,0
2324930324,Qaedat_Nusra,Qaedat_Nusra,1,1,3,4,8,0.75,0.010461701
2160795535,hassanrachidi82,hassanrachidi82,1,1,0,1,8,0,0.05029272
2481483762,Abohafs1883,Abohafs1883,1,0,2,2,8,0.5,0
19177461,BramJanssen,BramJanssen,1,0,1,1,8,0,0
190685193,AfricaACSS,AfricaACSS,1,0,1,1,8,0,0
380412065,highsurfer,highsurfer,1,1,0,1,8,0,0.05029272
64168137,arioDC,arioDC,1,2,0,2,8,1,0.099227471
1685332202,IslamicaOnline,IslamicaOnline,1,2,0,2,8,1,0.099227471
414589175,AMROOF1985,AMROOF1985,1,0,1,1,8,0,0
275554566,SAMujahida,SAMujahida,1,1,2,3,8,1,0.033391593
18555148,jjk_rr,jjk_rr,1,4,0,4,8,0.5,0.09791626
376840466,Ataralsalf,Ataralsalf,1,0,1,1,8,0,0
839721253,IsraelWC1,IsraelWC1,1,0,1,1,8,0,0
1031217546,mujahidinsallah,mujahidinsallah,1,0,1,1,8,0,0
1445077393,kingarturo23,kingarturo23,1,0,1,1,8,0,0
2599068100,AbuBakrAlSomali,AbuBakrAlSomali,1,4,1,5,8,0.9166667,0.143080765
2473766990,khorasan313,khorasan313,1,2,4,6,8,0.8,0.035172715
18424289,AJENews,AJENews,1,0,1,1,8,0,0
2626855406,TakfeeriWitness,TakfeeriWitness,1,0,1,1,8,0,0
2840764915,D_a1000,D_a1000,1,1,0,1,8,0,0.05029272
707764798,mecca_islever22,mecca_islever22,1,2,0,2,8,1,0.06075442
240398439,said1924,said1924,1,1,1,2,8,0,0.05029272
2246943357,88Khawlah,88Khawlah,1,1,0,1,8,0,0.05029272
1611113124,Muwsa_19,Muwsa_19,1,1,0,1,8,0,0.05029272
1575658158,Rebartic,Rebartic,1,1,0,1,8,0,0.05029272
621814509,AbuUsamaII,AbuUsamaII,1,0,1,1,8,0,0
306979592,ibn_alqaim,ibn_alqaim,1,0,1,1,8,0,0
2357601102,AhmadRebel01,AhmadRebel01,1,3,0,3,8,0.8333333,0.109689172
2400002935,salahuddin_sham,salahuddin_sham,1,0,1,1,8,0,0
952247196,IKallam,IKallam,1,0,1,1,8,0,0
2828542915,ShAboufadl,ShAboufadl,1,0,1,1,8,0,0
2200019934,Ansaruna,Ansaruna,1,0,2,2,8,1,0
2581636178,HatemMer,HatemMer,1,0,1,1,8,0,0
2715034728,Hajaj_Alajmi,Hajaj_Alajmi,1,0,2,2,8,0.5,0
2160600236,imas2607,imas2607,1,2,0,2,8,1,0.099227471
522527967,TaziMorocco,TaziMorocco,1,0,2,2,8,0.5,0
557557096,jushneraz,jushneraz,1,2,0,2,8,0.5,0.075003734
384640384,Naris69,Naris69,1,3,0,3,8,0.8333333,0.123938486
97297820,UmmDujanah_,UmmDujanah_,1,3,3,6,8,0.5833333,0.086096591
550086057,ShaykhZahir,ShaykhZahir,1,0,2,2,8,1,0
2273420743,Umm_Ibrah1m,Umm_Ibrah1m,1,0,1,1,8,0,0
350529055,moseph321,moseph321,1,1,0,1,8,0,0.05029272
2532845095,binabdellah,binabdellah,1,1,1,2,8,0,0.05029272
2814649909,shame_N,shame_N,1,3,2,5,8,0.75,0.084107467
2265097834,KompoundMedia,KompoundMedia,1,0,1,1,8,0,0
2487953016,Syrianfreedom17,Syrianfreedom17,1,1,0,1,8,0,0.05029272
2282170075,shamalsalam123,shamalsalam123,1,0,1,1,8,0,0
2333124337,09Ariful,09Ariful,1,2,0,2,8,1,0.083684313
2468357886,ISIS_Da3esh,ISIS_Da3esh,1,0,3,3,8,1,0
1535977219,aryansyazwan,aryansyazwan,1,5,0,5,8,0.8,0.16779178
1877831,nytimesworld,nytimesworld,1,0,1,1,8,0,0
301344608,AbuSuhaylah,AbuSuhaylah,1,5,0,5,8,0.6,0.146851012
525084535,1001milas,1001milas,1,1,0,1,8,0,0.05029272
2588813220,vv11vv3,vv11vv3,1,0,1,1,8,0,0
376776882,AbuJamajem,AbuJamajem,1,0,3,3,8,0.6666667,0
798107856,IslamicTruths,IslamicTruths,1,0,1,1,8,0,0
2596645092,AbuYahyaIS,AbuYahyaIS,1,3,1,4,8,0.5,0.102997717
2341513572,JnDar3a_2,JnDar3a_2,1,0,2,2,8,0.5,0
1539352968,long00way,long00way,1,0,2,2,8,0.5,0
2765269434,AbuYunus123,AbuYunus123,1,2,2,4,8,0.5,0.075003734
451619259,3am3ali,3am3ali,1,0,1,1,8,0,0
433334787,documentssy,documentssy,1,0,1,1,8,0,0
1410116160,abo_osama_n,abo_osama_n,1,0,1,1,8,0,0
256944737,AhlNussrah,AhlNussrah,1,0,1,1,8,0,0
2157882025,TahrirSy,TahrirSy,1,0,4,4,8,0.6666667,0
2666572616,abu_tawba,abu_tawba,1,5,3,8,8,0.7,0.168238927
268282720,khadziqon,khadziqon,1,1,0,1,8,0,0.05029272
96086891,MissionDawah,MissionDawah,1,0,1,1,8,0,0
2590255998,AbiMansoor,AbiMansoor,1,2,0,2,8,1,0.083684313
2776476618,albashaer_audio,albashaer_audio,1,0,1,1,8,0,0
2642193424,SwiftTwiter,SwiftTwiter,1,2,0,2,8,0,0.054062966
2458004581,Fida_07,Fida_07,1,0,1,1,8,0,0
2241997949,shami512r,shami512r,1,0,1,1,8,0,0
509488331,OfficialMDL,OfficialMDL,1,0,1,1,8,0,0
2298621162,MemishiRidvan,MemishiRidvan,1,3,0,3,8,1,0.094146014
496906795,Mosaab_nasir,Mosaab_nasir,1,0,1,1,8,0,0
276901157,sultan_alatwee,sultan_alatwee,1,0,3,3,8,0.6666667,0
2508008763,MdhereD,MdhereD,1,1,0,1,8,0,0.05029272
69971262,loonwatchers,loonwatchers,1,0,1,1,8,0,0
2596292492,observer_muslim,observer_muslim,1,2,0,2,8,0.5,0.061201568
35204442,maaazziin,maaazziin,1,3,0,3,8,0.8333333,0.123938486
470068622,Ibndaudtudu,Ibndaudtudu,1,2,0,2,8,1,0.06075442
223128994,BnNa111,BnNa111,1,3,2,5,8,0.6,0.063166699
2779491779,AbuQudamaTurki,AbuQudamaTurki,1,0,1,1,8,0,0
701705767,qardho1_somali,qardho1_somali,1,0,1,1,8,0,0
102149672,rasmoha,rasmoha,1,4,0,4,8,0.8333333,0.157330079
1971793466,iliassnoord,iliassnoord,1,3,0,3,8,1,0.094146014
1528114782,AboHamzaAldaraw,AboHamzaAldaraw,1,0,1,1,8,0,0
21114659,ForeignAffairs,ForeignAffairs,1,0,1,1,8,0,0
2172825412,TusiPolymath,TusiPolymath,1,0,2,2,8,0,0
1305063270,abuhamzaneh,abuhamzaneh,1,4,1,5,8,0.9166667,0.143080765
1559408492,ShortReminders,ShortReminders,1,0,1,1,8,0,0
7587032,SkyNews,SkyNews,1,0,1,1,8,0,0
514961392,Byan_o1,Byan_o1,1,0,2,2,8,0.5,0
209105136,tariqhaleem,tariqhaleem,1,0,1,1,8,0,0
43550765,bigfreeze313,bigfreeze313,1,1,1,2,8,0,0.05029272
18428189,LaurenBoothUK,LaurenBoothUK,1,0,1,1,8,0,0
2506862905,innovation_dp,innovation_dp,1,1,0,1,8,0,0.05029272
2292953404,BDSPalestine,BDSPalestine,1,1,0,1,8,0,0.05029272
270217542,farouqalfaqih,farouqalfaqih,1,5,0,5,8,0.7,0.168238927
299413847,InjusticeFacts,InjusticeFacts,1,0,1,1,8,0,0
1382035818,UmmSamaiyaah,UmmSamaiyaah,1,0,1,1,8,0,0
1688318328,nukhba_alfeker,nukhba_alfeker,1,0,1,1,8,0,0
2568499579,jaisy_ja,jaisy_ja,1,1,0,1,8,0,0.05029272
2300326285,abou_1996,abou_1996,1,1,0,1,8,0,0.05029272
548221333,sabiq_jihadmal,sabiq_jihadmal,1,0,1,1,8,0,0
2753212992,Man34xxx,Man34xxx,1,0,1,1,8,0,0
1897771604,ansarulsham,ansarulsham,1,0,1,1,8,0,0
45920883,wordofallah,wordofallah,1,0,2,2,8,1,0
2479960717,MalikAzis313,MalikAzis313,1,2,0,2,8,1,0.099227471
2737091260,FulaanAbu,FulaanAbu,1,1,0,1,8,0,0.05029272
405254899,IbnEnu,IbnEnu,1,0,3,3,8,1,0
2762224374,arinee13,arinee13,1,2,1,3,8,1,0.06075442
1227469614,SalafiMediaB,SalafiMediaB,1,2,0,2,8,0.5,0.075003734
351155005,ambassey,ambassey,1,2,0,2,8,1,0.083684313
2493199232,PetrCech,PetrCech,1,0,1,1,8,0,0
132330417,IslamicThinking,IslamicThinking,1,0,2,2,8,1,0
2752295864,IslamZober,IslamZober,1,1,0,1,8,0,0.05029272
1511863236,marley68xx,marley68xx,1,1,0,1,8,0,0.05029272
2541999628,ThierryHenry,ThierryHenry,1,0,1,1,8,0,0
141931362,PerfectQuran,PerfectQuran,1,0,1,1,8,0,0
2615555168,jackfreeman121,jackfreeman121,1,1,0,1,8,0,0.05029272
592196760,3bduu92,3bduu92,1,0,1,1,8,0,0
2535011483,abdul_aziz_80,abdul_aziz_80,1,1,1,2,8,0,0.05029272
481604792,omarkhamboo,omarkhamboo,1,0,1,1,8,0,0
2537108738,mibrahimm465,mibrahimm465,1,2,0,2,8,1,0.099227471
2811802963,sardarbabashex,sardarbabashex,1,1,0,1,8,0,0.05029272
121812371,OmarShabbi,OmarShabbi,1,0,1,1,8,0,0
2795288008,AbuIzzadeen2,AbuIzzadeen2,1,3,3,6,8,0.8,0.084107467
2738107884,mujahidlkanadi,mujahidlkanadi,1,5,0,5,8,0.6,0.146851012
712422923,qatadah_athary,qatadah_athary,1,0,1,1,8,0,0
47101500,intelwire,intelwire,1,0,1,1,8,0,0
2789521019,IbnMouhammad,IbnMouhammad,1,3,0,3,8,0.6666667,0.108395328
1056552596,CaliphateCop,CaliphateCop,1,2,1,3,8,1,0.099227471
2605069975,ummabudhar,ummabudhar,1,1,2,3,8,1,0.048934752
1588147934,Vero1naske,Vero1naske,1,3,0,3,8,0.8333333,0.123938486
860643498,KorasaN_1428,KorasaN_1428,1,0,2,2,8,0.5,0
2304456440,Hystanes,Hystanes,1,1,0,1,8,0,0.05029272
108836623,Hamza_Africa,Hamza_Africa,1,0,1,1,8,0,0
859420550,khilafat313,khilafat313,1,0,1,1,8,0,0
2830088146,ibn_3omar,ibn_3omar,1,4,0,4,8,0.75,0.118857029
25049056,France24_en,France24_en,1,0,2,2,8,0,0
1583303005,HarryOdhiambo,HarryOdhiambo,1,1,0,1,8,0,0.05029272
2417211479,aleena94eed,aleena94eed,1,3,0,3,8,0.8333333,0.109689172
2594355296,AbuSayf88,AbuSayf88,1,4,1,5,8,0.75,0.118857029
1205123202,brazuca,brazuca,1,0,1,1,8,0,0
49952966,Hathim,Hathim,1,0,1,1,8,0,0
2771859675,abuubaydah37,abuubaydah37,1,3,1,4,8,0.8333333,0.10703736
417413352,macp68,macp68,1,1,0,1,8,0,0.05029272
154122533,Urwatulwuthqa_,Urwatulwuthqa_,1,1,1,2,8,1,0.010461701
264991800,QasimKahloon,QasimKahloon,1,0,1,1,8,0,0
1572354420,demiragumit,demiragumit,1,2,0,2,8,1,0.083684313
710064516,TheRealAC3,TheRealAC3,1,0,1,1,8,0,0
1368701425,FreeJahar_,FreeJahar_,1,0,1,1,8,0,0
129251925,Aal_Aseer,Aal_Aseer,1,3,2,5,8,1,0.094146014
2342632039,abofaisal90,abofaisal90,1,0,1,1,8,0,0
436189806,AbujomaaGaza,AbujomaaGaza,1,0,1,1,8,0,0
422099604,pamioski,pamioski,1,1,0,1,8,0,0.05029272
1685994210,altemyat_t,altemyat_t,1,1,0,1,8,0,0.05029272
2811607786,AndaIus,AndaIus,1,0,2,2,8,0.5,0
2151660275,jzurt_alarb,jzurt_alarb,1,0,1,1,8,0,0
47963958,BroVictorious,BroVictorious,1,0,1,1,8,0,0
28785486,ABC,ABC,1,0,1,1,8,0,0
2388900690,MoFarooq2,MoFarooq2,1,1,0,1,8,0,0.05029272
241810287,Binothaymeen,Binothaymeen,1,0,1,1,8,0,0
533085085,MesutOzil1088,MesutOzil1088,1,0,1,1,8,0,0
628702263,Women_Of_Jannah,Women_Of_Jannah,1,0,1,1,8,0,0
2264743045,jabhatalnsra,jabhatalnsra,1,0,1,1,8,0,0
2580987156,JN_Dimashq,JN_Dimashq,1,0,2,2,8,0.5,0
2849717539,achammi456,achammi456,1,2,0,2,8,0.5,0.075003734
700398915,aadilmalik101,aadilmalik101,1,4,0,4,8,0.75,0.118857029
1197325675,jatircaca,jatircaca,1,2,1,3,8,1,0.083684313
1966554482,officialcafu,officialcafu,1,0,1,1,8,0,0
439893395,sakher_11,sakher_11,1,0,2,2,8,0.5,0
444579252,IslamicInstinct,IslamicInstinct,1,0,1,1,8,0,0
2569059769,um_abdurrahman_,um_abdurrahman_,1,3,0,3,8,0.5,0.110053587
750370309,BEllAEmz,BEllAEmz,1,1,0,1,8,0,0.05029272
1965473293,MaysunSaud,MaysunSaud,1,4,0,4,8,0.75,0.118857029
2612772379,Ansaar_Gbhat2,Ansaar_Gbhat2,1,0,2,2,8,0.5,0
588562000,Just_a_muslimah,Just_a_muslimah,1,0,1,1,8,0,0
412171915,warcrybd,warcrybd,1,1,0,1,8,0,0.05029272
1352351522,MRumaisah,MRumaisah,1,1,1,2,8,0,0.05029272
1556102971,BrotherJalaal,BrotherJalaal,1,3,3,6,8,0.8333333,0.109689172
2263105532,EjmAlrai,EjmAlrai,1,0,4,4,8,0.8333333,0
2674114676,al_tahaya3,al_tahaya3,1,0,1,1,8,0,0
342671527,mullahism,mullahism,1,1,2,3,8,0.6666667,0.024711015
89211069,elias244,elias244,1,1,0,1,8,0,0.05029272
988561728,najihhh15,najihhh15,1,0,1,1,8,0,0
2775728452,ABMOGA,ABMOGA,1,0,2,2,8,0.5,0
577356138,Sallafy_AlQaeda,Sallafy_AlQaeda,1,1,0,1,8,0,0.05029272
47071700,robynleekriel,robynleekriel,1,0,1,1,8,0,0
2291274422,Tamerlane1398,Tamerlane1398,1,5,0,5,8,0.5,0.138170433
1564295797,elcihad3,elcihad3,1,1,0,1,8,0,0.05029272
88359566,dailyreminders,dailyreminders,1,0,1,1,8,0,0
1234879124,aboomarlatakia4,aboomarlatakia4,1,0,1,1,8,0,0
2617983676,Sawtul_Jihad,Sawtul_Jihad,1,0,1,1,8,0,0
2458829641,7akem50,7akem50,1,0,1,1,8,0,0
390873963,monasrasra,monasrasra,1,0,1,1,8,0,0
2151367538,iraq_Crimes,iraq_Crimes,1,0,1,1,8,0,0
2522727311,abuabdussalam99,abuabdussalam99,1,3,0,3,8,1,0.094146014
2547338052,akhbartaliban,akhbartaliban,1,0,1,1,8,0,0
1012220833,SoulaymanCongo,SoulaymanCongo,1,1,0,1,8,0,0.05029272
618972073,GuiltyMuslim,GuiltyMuslim,1,3,3,6,8,0.6,0.04762354
2625356847,EmasuHaresta,EmasuHaresta,1,4,0,4,8,0.75,0.118857029
2596193335,KhilafahSunnah,KhilafahSunnah,1,2,0,2,8,0.5,0.075003734
710132795,ImamHanbal,ImamHanbal,1,1,0,1,8,0,0.05029272
1877263428,sowaralsham,sowaralsham,1,0,1,1,8,0,0
23839835,jeremyscahill,jeremyscahill,1,0,2,2,8,1,0
2791064674,94d5f0e9a007419,94d5f0e9a007419,1,2,0,2,8,1,0.099227471
539673709,SoldiersofIslam,SoldiersofIslam,1,0,1,1,8,0,0
381633708,AnonDawla,AnonDawla,1,2,1,3,8,1,0.099227471
1252115672,aahh971,aahh971,1,0,1,1,8,0,0
148653311,jenanmoussa,jenanmoussa,1,0,1,1,8,0,0
870434053,zahran1970,zahran1970,1,0,3,3,8,0.8333333,0
1625245002,HudhaifahD,HudhaifahD,1,1,0,1,8,0,0.05029272
2550089052,prinks66,prinks66,1,1,1,2,8,0,0.05029272
107005340,SixthBoo,SixthBoo,1,2,0,2,8,1,0.099227471
2844575155,Aluaka555,Aluaka555,1,0,2,2,8,0.5,0
292898259,thewarjournal,thewarjournal,1,0,1,1,8,0,0
935249443,127913081,127913081,1,0,1,1,8,0,0
385631878,alnusraha,alnusraha,1,0,1,1,8,0,0
2437170836,abd10101010,abd10101010,1,4,0,4,8,0.9166667,0.143080765
1370310307,julaibib_11,julaibib_11,1,0,2,2,8,0.5,0
1244908494,GreenBirds111,GreenBirds111,1,0,1,1,8,0,0
2657470299,abuubaydah0072,abuubaydah0072,1,4,1,5,8,0.9166667,0.143080765
2288797580,JabhtAnNusrah_s,JabhtAnNusrah_s,1,0,1,1,8,0,0
940885921,ummsuhaym,ummsuhaym,1,0,2,2,8,1,0
2502805440,All2tachy,All2tachy,1,1,0,1,8,0,0.05029272
1240254422,SlaveofAllah22,SlaveofAllah22,1,4,0,4,8,0.9166667,0.143080765
1107249236,aboasama2011201,aboasama2011201,1,1,1,2,8,0,0.05029272
2662713446,mutabe1,mutabe1,1,0,2,2,8,0.5,0
2408663186,permana27419314,permana27419314,1,1,0,1,8,0,0.05029272
2378942667,alhekma22,alhekma22,1,1,0,1,8,0,0.05029272
2205272359,sami_oride,sami_oride,1,0,3,3,8,0.8333333,0
549177664,Mohhager,Mohhager,1,0,2,2,8,0.5,0
117229897,VigilanteDave,VigilanteDave,1,1,0,1,8,0,0.05029272
2675951975,Bari12345Ahmed,Bari12345Ahmed,1,1,0,1,8,0,0.05029272
1944963578,shomokhalislam2,shomokhalislam2,1,0,1,1,8,0,0
1917471241,jihad_princess,jihad_princess,1,2,1,3,8,1,0.099227471
153733644,alshaf3ey,alshaf3ey,1,0,1,1,8,0,0
2707704374,mohebaljreb,mohebaljreb,1,0,1,1,8,0,0
403098193,BakrAbuZaid,BakrAbuZaid,1,0,1,1,8,0,0
1591691863,MujahidahNurii,MujahidahNurii,1,0,1,1,8,0,0
2195180169,coul_ml,coul_ml,1,1,1,2,8,0,0.05029272
2367703812,Abu_waleed_bd,Abu_waleed_bd,1,6,0,6,8,0.56666666,0.178617896
1020807968,Maratabali1Ali,Maratabali1Ali,1,1,0,1,8,0,0.05029272
2566638420,gatot_sabrato,gatot_sabrato,1,3,0,3,8,0.16666667,0.078773981
2606975870,smile4riju,smile4riju,1,1,0,1,8,0,0.05029272
1716636547,mohsenatiya,mohsenatiya,1,1,0,1,8,0,0.05029272
478890910,Ansaarullaah1,Ansaarullaah1,1,0,1,1,8,0,0
135515077,NKingofDC,NKingofDC,1,0,1,1,8,0,0
529746907,IbnBashir92,IbnBashir92,1,3,1,4,8,0.8333333,0.109689172
703253476,ibnabdulmajid,ibnabdulmajid,1,0,1,1,8,0,0
855362545,ndushmambo,ndushmambo,1,1,0,1,8,0,0.05029272
1238944800,sulemanshah460,sulemanshah460,1,1,0,1,8,0,0.05029272
537988301,MO_3AZA,MO_3AZA,1,0,1,1,8,0,0
16076032,ggreenwald,ggreenwald,1,0,1,1,8,0,0
2483473685,seifulmaslul123,seifulmaslul123,1,1,2,3,8,1,0.048934752
2375666977,Experience_jiha,Experience_jiha,1,0,1,1,8,0,0
2372652595,mujanid87,mujanid87,1,2,1,3,8,0.6666667,0.035172715
530042421,DrDimashqiah,DrDimashqiah,1,0,1,1,8,0,0
273305152,wijkagMoerwijk,wijkagMoerwijk,1,1,0,1,8,0,0.05029272
1395379826,RevFalcon84,RevFalcon84,1,0,2,2,8,1,0
2715405974,ShaamAlJihad,ShaamAlJihad,1,1,0,1,8,0,0.05029272
831573674,shahadanews,shahadanews,1,0,1,1,8,0,0
1891520184,abakhattab,abakhattab,1,0,1,1,8,0,0
2797948714,muhajirishaam01,muhajirishaam01,1,2,4,6,8,0.8333333,0.058102608
598331179,Adamitv,Adamitv,1,1,0,1,8,0,0.05029272
332320606,edlnews,edlnews,1,0,1,1,8,0,0
822136759,SalafiSista33,SalafiSista33,1,0,1,1,8,0,0
1256837108,bobakr12,bobakr12,1,0,1,1,8,0,0
2405027900,AlGolan1,AlGolan1,1,0,1,1,8,0,0
1867370562,daibbe11,daibbe11,1,2,0,2,8,1,0.099227471
1828048980,al_sainat,al_sainat,1,2,0,2,8,1,0.06075442
1662472286,PatrickKluivert,PatrickKluivert,1,0,1,1,8,0,0
315609199,DawudBoxer,DawudBoxer,1,0,1,1,8,0,0
2615201923,LoujinaA,LoujinaA,1,1,0,1,8,0,0.05029272
807095,nytimes,nytimes,1,0,3,3,8,0.5,0
2506510525,binsayyid014,binsayyid014,1,1,0,1,8,0,0.05029272
1452855498,ahb_nsh,ahb_nsh,1,0,1,1,8,0,0
2691256524,ESejfullah,ESejfullah,1,3,0,3,8,1,0.132619065
740336334,GarethBale11,GarethBale11,1,0,1,1,8,0,0
2252132598,Adnan_Alawlaqi,Adnan_Alawlaqi,1,0,1,1,8,0,0
2189775134,ana_Saajid,ana_Saajid,1,3,0,3,8,1,0.132619065
26792275,ForeignPolicy,ForeignPolicy,1,0,1,1,8,0,0
14569869,Channel4News,Channel4News,1,0,2,2,8,0,0
2588758428,NasratT,NasratT,1,1,0,1,8,0,0.05029272
177263031,a51m285,a51m285,1,1,1,2,8,0,0.05029272
518771143,martnbeirut,martnbeirut,1,0,1,1,8,0,0
1539199549,Afghananalyst,Afghananalyst,1,0,1,1,8,0,0
2823967345,JN_Hama,JN_Hama,1,0,2,2,8,0.5,0
2546160279,ieffendi23,ieffendi23,1,1,0,1,8,0,0.05029272
113889961,liveleak,liveleak,1,0,1,1,8,0,0
2518471446,ND_Shami,ND_Shami,1,0,2,2,8,0.5,0
1482748278,awebb79,awebb79,1,1,0,1,8,0,0.05029272
2282083194,Daish_OnLine,Daish_OnLine,1,0,1,1,8,0,0
206164876,the_true_dawn,the_true_dawn,1,0,1,1,8,0,0
355193751,Ibn_Shaheed,Ibn_Shaheed,1,0,1,1,8,0,0
106288036,ramyourk,ramyourk,1,3,0,3,8,0.5,0.102997717
1722043892,AhmedSentey,AhmedSentey,1,1,0,1,8,0,0.05029272
2447234071,Shamisurgeon,Shamisurgeon,1,0,2,2,8,0.5,0
1887491106,Abu_Jibreel,Abu_Jibreel,1,0,2,2,8,1,0
1388369107,alagha1989,alagha1989,1,0,1,1,8,0,0
342349033,Umm_Saalihah,Umm_Saalihah,1,1,2,3,8,1,0.048934752
2279036160,jondaqsa,jondaqsa,1,0,3,3,8,0.8333333,0
203962399,_axaa,_axaa,1,0,1,1,8,0,0
1687180706,1999_rehan,1999_rehan,1,3,0,3,8,0.33333334,0.094510429
2542753232,ATouchOfIslam,ATouchOfIslam,1,2,1,3,8,0.6666667,0.035172715
1690719800,misscheeky666,misscheeky666,1,0,1,1,8,0,0
2383042147,syrianalann,syrianalann,1,1,1,2,8,0.5,0.024711015
2423805613,haleem_t_t,haleem_t_t,1,0,1,1,8,0,0
155178681,ibnAljawzy,ibnAljawzy,1,0,1,1,8,0,0
2711148252,YahyaAbdukareem,YahyaAbdukareem,1,1,0,1,8,0,0.05029272
2374817528,JabhatAlNusraNL,JabhatAlNusraNL,1,0,1,1,8,0,0
2485849728,mgahdmaghool,mgahdmaghool,1,0,1,1,8,0,0
1168693118,bilalalshame65,bilalalshame65,1,0,1,1,8,0,0
1849546734,Againstshia,Againstshia,1,1,0,1,8,0,0.05029272
2676545577,AllyMapanga,AllyMapanga,1,4,0,4,8,0.9166667,0.143080765
1433702072,saleelalmajd1,saleelalmajd1,1,0,2,2,8,0.5,0
2423707734,AbuEethar,AbuEethar,1,0,2,2,8,1,0
2834585741,Muwahiddah_,Muwahiddah_,1,3,0,3,8,0.8333333,0.123938486
2714261659,ShaamTommorow,ShaamTommorow,1,2,0,2,8,1,0.083684313
136009889,Cordoba_Academy,Cordoba_Academy,1,0,1,1,8,0,0
1615321290,sophieBaloshi,sophieBaloshi,1,0,1,1,8,0,0
1425266934,SyriaDirect,SyriaDirect,1,0,1,1,8,0,0
2834651397,AlMuhiuddin,AlMuhiuddin,1,4,0,4,8,0.75,0.118857029
2790578456,AbyHyraira,AbyHyraira,1,0,1,1,8,0,0
98777476,LGhaliyaaR,LGhaliyaaR,1,2,1,3,8,1,0.099227471
2569623835,mojhdk,mojhdk,1,0,3,3,8,0.8333333,0
1186249098,HsmInfo1,HsmInfo1,1,0,1,1,8,0,0
597550134,iamsamira_,iamsamira_,1,0,1,1,8,0,0
2801367453,AamirKhan351,AamirKhan351,1,1,0,1,8,0,0.05029272
1964890550,NoahBonsey,NoahBonsey,1,0,1,1,8,0,0
365634652,athyph10,athyph10,1,2,1,3,8,0.5,0.075003734
2242894397,sheikhabuqatada,sheikhabuqatada,1,0,3,3,8,0.16666667,0
2479512128,mohajr112233,mohajr112233,1,0,1,1,8,0,0
1259756132,umm_sufyaan1,umm_sufyaan1,1,0,1,1,8,0,0
563600054,CarnegieMEC,CarnegieMEC,1,0,1,1,8,0,0
2247711458,lamouchiborhen,lamouchiborhen,1,1,0,1,8,0,0.05029272
455072491,shuzaifa1,shuzaifa1,1,1,0,1,8,0,0.05029272
19028716,iFalasteen,iFalasteen,1,0,1,1,8,0,0
2171230973,Mohammed0686,Mohammed0686,1,2,0,2,8,1,0.083684313
2453527320,Raqqa_Sl,Raqqa_Sl,1,0,1,1,8,0,0
1461771216,MuhammedWilson,MuhammedWilson,1,1,0,1,8,0,0.05029272
527883269,sandronesta13,sandronesta13,1,0,1,1,8,0,0
142189748,hanjam47,hanjam47,1,1,0,1,8,0,0.05029272
2402868300,muqawamahmedia,muqawamahmedia,1,1,2,3,8,1,0.033391593
244178035,MohammedSS1,MohammedSS1,1,0,1,1,8,0,0
273341590,abumuwahhid1402,abumuwahhid1402,1,0,1,1,8,0,0
2440092873,mujahidinshalla,mujahidinshalla,1,2,0,2,8,1,0.099227471
2658589904,AmirSanchez27,AmirSanchez27,1,4,0,4,8,0.9166667,0.143080765
1412324610,mujahed_lens_,mujahed_lens_,1,0,1,1,8,0,0
22240612,AlArabiya_Eng,AlArabiya_Eng,1,0,3,3,8,0.5,0
2491702663,paulpogba,paulpogba,1,0,1,1,8,0,0
184966548,muradbatal,muradbatal,1,0,1,1,8,0,0
2662371231,PureHaqq,PureHaqq,1,2,0,2,8,1,0.083684313
287399358,Ibnqaiem,Ibnqaiem,1,0,1,1,8,0,0
1642618315,GlobalShariah,GlobalShariah,1,1,0,1,8,0,0.05029272
142375504,m_t143,m_t143,1,1,1,2,8,0,0.05029272
21323268,nyse,nyse,1,0,1,1,8,0,0
1146676489,YeahImMuslim,YeahImMuslim,1,0,1,1,8,0,0
247750274,MohammedGhazzal,MohammedGhazzal,1,1,3,4,8,0.6666667,0.024711015
2266521224,glikmet,glikmet,1,1,0,1,8,0,0.05029272
1638096558,ibaadulrahmaan,ibaadulrahmaan,1,2,0,2,8,0.5,0.075003734
1575739057,ArabicVocab,ArabicVocab,1,0,2,2,8,0,0
244571847,HaraldDoornbos,HaraldDoornbos,1,0,1,1,8,0,0
5988062,TheEconomist,TheEconomist,1,0,1,1,8,0,0
2716983021,Easharms,Easharms,1,1,0,1,8,0,0.05029272
2565332734,Abu_khiyre,Abu_khiyre,1,4,0,4,8,0.75,0.118857029
300867408,nomansword,nomansword,1,1,0,1,8,0,0.05029272
163733330,Lateefuddien,Lateefuddien,1,3,0,3,8,0.8333333,0.123938486
478831938,syedammarH,syedammarH,1,2,0,2,8,1,0.099227471
87416722,SkyNewsBreak,SkyNewsBreak,1,0,1,1,8,0,0
2263136922,aboabdulmalek1,aboabdulmalek1,1,0,3,3,8,0.8333333,0
14460241,WilliamsJon,WilliamsJon,1,0,1,1,8,0,0
2608881686,MartyrForAllah,MartyrForAllah,1,1,0,1,8,0,0.05029272
1015446194,keyman1008,keyman1008,1,1,0,1,8,0,0.05029272
181428282,sh4i,sh4i,1,0,1,1,8,0,0
2447073384,abunaimmoro,abunaimmoro,1,2,1,3,8,0.8333333,0.073645766
449568902,siryahora,siryahora,1,0,1,1,8,0,0
2508611725,State_of_1slam,State_of_1slam,1,0,1,1,8,0,0
2682872001,fatyhjolany,fatyhjolany,1,0,1,1,8,0,0
1994321,FRANCE24,FRANCE24,1,0,1,1,8,0,0
1223606096,ummuAish,ummuAish,1,1,1,2,8,0,0.05029272
2659017097,Qassam_English,Qassam_English,1,0,2,2,8,1,0
1083138451,M_8_D,M_8_D,1,0,1,1,8,0,0
1496506783,AbdulAzizTreefi,AbdulAzizTreefi,1,0,1,1,8,0,0
523690624,ArabGeezer,ArabGeezer,1,0,1,1,8,0,0
387032512,GhaithShennib,GhaithShennib,1,0,1,1,8,0,0
2797789828,fezoo111,fezoo111,1,1,2,3,8,0.5,0.024711015
422765206,ShutGuantanamo,ShutGuantanamo,1,0,1,1,8,0,0
74769064,tweetsintheME,tweetsintheME,1,0,1,1,8,0,0
2392646318,MaldifiWitness,MaldifiWitness,1,0,1,1,8,0,0
15721256,ISMPalestine,ISMPalestine,1,0,1,1,8,0,0
1330602824,ChaudhryAQIB1,ChaudhryAQIB1,1,1,0,1,8,0,0.05029272
323511183,kochai_halak,kochai_halak,1,0,1,1,8,0,0
20800420,inaleemz,inaleemz,1,1,1,2,8,0,0.05029272
1967460512,ahlalhdeeth_12,ahlalhdeeth_12,1,0,1,1,8,0,0
367584303,AnandMohammad,AnandMohammad,1,5,0,5,8,0.45,0.122627275
1269425228,Manuel_Neuer,Manuel_Neuer,1,0,1,1,8,0,0
1669293181,Fadl_Saleh,Fadl_Saleh,1,2,0,2,8,1,0.06075442
331474127,PutYourDeen1st,PutYourDeen1st,1,0,1,1,8,0,0
705127670,676376847,676376847,1,0,1,1,8,0,0
1723065638,Lattakian1,Lattakian1,1,0,1,1,8,0,0
2288706859,SGHURABAA,SGHURABAA,1,1,1,2,8,1,0.010461701
224847164,AbuAdnani101,AbuAdnani101,1,0,1,1,8,0,0
2813388098,AlkurdiYousif,AlkurdiYousif,1,1,0,1,8,0,0.05029272
2449991003,fatimatjie,fatimatjie,1,1,0,1,8,0,0.05029272
2459526543,ayuop_,ayuop_,1,0,2,2,8,0.5,0
36562335,LanceCahill,LanceCahill,1,2,0,2,8,0,0.054062966
596895180,youngmujahideen,youngmujahideen,1,3,2,5,8,1,0.094146014
268434338,Bintaimiahia,Bintaimiahia,1,0,1,1,8,0,0
2747557380,aboeahsan,aboeahsan,1,1,0,1,8,0,0.05029272
287401589,hewitt_mufc,hewitt_mufc,1,1,0,1,8,0,0.05029272
2725570173,ysf_muhajir,ysf_muhajir,1,1,1,2,8,0.5,0.024711015
602040022,JbhatALnusra,JbhatALnusra,1,0,2,2,8,0.5,0
995649451,Ansaar_Gbhat,Ansaar_Gbhat,1,0,2,2,8,0.5,0
2460411858,cocoprats966,cocoprats966,1,1,0,1,8,0,0.05029272
2598758384,ibnmuslim1,ibnmuslim1,1,3,1,4,8,0.33333334,0.085912582
296871927,obmlive,obmlive,1,0,1,1,8,0,0
2609211406,IbnAdamX,IbnAdamX,1,0,1,1,8,0,0
256698383,IbnJuzay,IbnJuzay,1,1,0,1,8,0,0.05029272
347301963,basayeer,basayeer,1,0,1,1,8,0,0
339617307,Ibn_Adam95,Ibn_Adam95,1,0,1,1,8,0,0
535521390,iAbuHudhayfah,iAbuHudhayfah,1,1,1,2,8,0.5,0.024711015
2647091335,doammuslims,doammuslims,1,0,1,1,8,0,0
2199365314,almohagreen0,almohagreen0,1,0,2,2,8,0.5,0
1575381217,turki_saad24,turki_saad24,1,0,2,2,8,0.5,0
1230006500,silenttweep,silenttweep,1,3,6,9,8,0.73333335,0.054762142
2607474970,nanie_mazui,nanie_mazui,1,1,0,1,8,0,0.05029272
254536058,maiwandafghani,maiwandafghani,1,2,3,5,8,0.5833333,0.044217709
2362173923,WhyBDS,WhyBDS,1,1,0,1,8,0,0.05029272
1630530026,AbuMu7ammad1434,AbuMu7ammad1434,1,4,0,4,8,0.9166667,0.143080765
241298036,Mitch_Swenson,Mitch_Swenson,1,1,0,1,8,0,0.05029272
339700357,ConcernedMuslim,ConcernedMuslim,1,1,1,2,8,1,0.010461701
1514171023,FBaresi,FBaresi,1,0,1,1,8,0,0
1666280082,UmmAbdulmalik,UmmAbdulmalik,1,2,2,4,8,1,0.083684313
2679302995,ansardeenfront,ansardeenfront,1,0,3,3,8,0.6666667,0
1881926504,calltotawheeed,calltotawheeed,1,4,0,4,8,0.8333333,0.157330079
27061115,IntelTweet,IntelTweet,1,0,2,2,8,0.5,0
2823875454,Edlib_Jn,Edlib_Jn,1,0,2,2,8,0.5,0
446229421,Jihad_UK,Jihad_UK,1,0,1,1,8,0,0
1559948292,radioalfurqaan,radioalfurqaan,1,0,1,1,8,0,0
1344760921,cutreina,cutreina,1,1,0,1,8,0,0.05029272
2451467360,AbdulSalaam_M,AbdulSalaam_M,1,1,3,4,8,1,0.033391593
393440365,mhesne,mhesne,1,0,2,2,8,0.5,0
1178725555,AfghanAffairs,AfghanAffairs,1,0,1,1,8,0,0
2790976733,JNQalamon,JNQalamon,1,0,2,2,8,0.5,0
543550762,JUST_OVRO,JUST_OVRO,1,5,0,5,8,0.55,0.168156195
66481550,DaveedGR,DaveedGR,1,0,1,1,8,0,0
2450353562,Aassdd1930019,Aassdd1930019,1,0,1,1,8,0,0
300314020,sahehjame,sahehjame,1,0,1,1,8,0,0
3108351,WSJ,WSJ,1,0,1,1,8,0,0
71298686,TheStudyofWar,TheStudyofWar,1,0,1,1,8,0,0
2574446250,seekktruth,seekktruth,1,0,2,2,8,1,0
431648445,aron_ld,aron_ld,1,0,3,3,8,0.8333333,0
2467791,washingtonpost,washingtonpost,1,0,2,2,8,0,0
1665312720,patel_ismael,patel_ismael,1,3,2,5,8,0.6666667,0.108395328
967995150,AbuNusaybahUK,AbuNusaybahUK,1,0,3,3,8,1,0
588902166,mu_sab4,mu_sab4,1,0,2,2,8,0.5,0
128216887,jonsnowC4,jonsnowC4,1,0,1,1,8,0,0
18476904,infroc,infroc,1,1,0,1,8,0,0.05029272
265285487,Asadullah_2012,Asadullah_2012,1,0,1,1,8,0,0
2777837454,dawladawla1,dawladawla1,1,1,0,1,8,0,0.05029272
1289742320,FarazAdm,FarazAdm,1,0,1,1,8,0,0
2439180206,abuazizbuhoriy,abuazizbuhoriy,1,3,3,6,8,0.9166667,0.092788046
1886089153,husham47,husham47,1,2,0,2,8,1,0.083684313
5402612,BBCBreaking,BBCBreaking,1,0,3,3,8,1,0
2847928387,ObedPadr,ObedPadr,1,1,0,1,8,0,0.05029272
423817285,abdulmalekalwan,abdulmalekalwan,1,0,1,1,8,0,0
1205858388,Bodey_Shaz,Bodey_Shaz,1,1,0,1,8,0,0.05029272
1286500459,YaminNaeem,YaminNaeem,1,1,1,2,8,0,0.05029272
1204310719,siambdlax,siambdlax,1,1,0,1,8,0,0.05029272
224522382,7AZ1M,7AZ1M,1,0,2,2,8,0.5,0
1853976738,JahidaMuhsina,JahidaMuhsina,1,1,0,1,8,0,0.05029272
2728489217,ShaykhAhmadGems,ShaykhAhmadGems,1,0,1,1,8,0,0
85913912,Belalmd12,Belalmd12,1,0,1,1,8,0,0
2383278401,h2hussainy,h2hussainy,1,1,0,1,8,0,0.05029272
322302274,Layla_Mire,Layla_Mire,1,0,1,1,8,0,0
2560356720,abohmzaalmhgr,abohmzaalmhgr,1,0,1,1,8,0,0
2590962048,MeMuddu,MeMuddu,1,2,0,2,8,1,0.06075442
717484539,AManLikeMe,AManLikeMe,1,1,2,3,8,0.8333333,0.024711015
396325380,alhafs,alhafs,1,1,0,1,8,0,0.05029272
279179876,islambouly,islambouly,1,0,1,1,8,0,0
2788487789,AYapci,AYapci,1,2,0,2,8,1,0.083684313
730952316,mona_12a,mona_12a,1,0,1,1,8,0,0
232125063,AlGhurabaah,AlGhurabaah,1,0,1,1,8,0,0
1631187697,almo7ed34,almo7ed34,1,0,1,1,8,0,0
2305782515,ShIbnTaymiyyah,ShIbnTaymiyyah,1,0,3,3,8,0.33333334,0
2588275534,AbuJarrahElsham,AbuJarrahElsham,1,0,1,1,8,0,0
88273770,albayan31,albayan31,1,0,1,1,8,0,0
637170543,saadsaa45454656,saadsaa45454656,1,0,1,1,8,0,0
425980786,maichmaichez9,maichmaichez9,1,1,0,1,8,0,0.05029272
1548317628,LuisFigo,LuisFigo,1,0,1,1,8,0,0
1372648388,Drop_shot_king,Drop_shot_king,1,1,0,1,8,0,0.05029272
778335236,ArshanAlAnsari,ArshanAlAnsari,1,0,1,1,8,0,0
598569991,ansaransar20,ansaransar20,1,0,2,2,8,0.5,0
1292497928,asadullah1406,asadullah1406,1,1,1,2,8,0,0.05029272
838464523,IFLScience,IFLScience,1,0,1,1,8,0,0
66974786,iHikmawanto,iHikmawanto,1,1,0,1,8,0,0.05029272
234058909,palinoia,palinoia,1,0,1,1,8,0,0
201487534,HarunMaruf,HarunMaruf,1,0,1,1,8,0,0
2823943346,JnHoms,JnHoms,1,0,2,2,8,0.5,0
1000666327,RazaAhmad245,RazaAhmad245,1,2,0,2,8,1,0.06075442
2437182710,Aanamajahdan,Aanamajahdan,1,1,0,1,8,0,0.05029272
272528635,Qayyum622CE,Qayyum622CE,1,0,1,1,8,0,0
1440838909,AbuQaeqae1924,AbuQaeqae1924,1,1,0,1,8,0,0.05029272
2734388642,FatihIraqi,FatihIraqi,1,3,2,5,8,0.6666667,0.108395328
2607183279,alitvsan,alitvsan,1,1,0,1,8,0,0.05029272
224130580,hamidul1,hamidul1,1,3,1,4,8,0.6666667,0.085465435
2373383770,jebril415,jebril415,1,1,0,1,8,0,0.05029272
2608232085,AzerbaijaniMC,AzerbaijaniMC,1,4,1,5,8,0.8333333,0.157330079
1538913943,AbuYahya121,AbuYahya121,1,0,1,1,8,0,0
2335536802,sned115,sned115,1,0,1,1,8,0,0
1397487284,pleaoftheummah,pleaoftheummah,1,0,1,1,8,0,0
2594502451,loinnation,loinnation,1,2,0,2,8,1,0.099227471
108459932,ajmalhamid,ajmalhamid,1,0,1,1,8,0,0
1449588684,AbooJihad2013,AbooJihad2013,1,606,424,1030,8,0.001387763,0.896125616
2539321368,AbuQudamaaa,AbuQudamaaa,1,3,3,6,8,0.8,0.084107467
2816518495,yeuwssye,yeuwssye,1,2,0,2,8,1,0.083684313
1904670823,Dawah_Is_Easy,Dawah_Is_Easy,1,3,0,3,8,0.5,0.102997717
280721585,YusuffMorris,YusuffMorris,1,0,1,1,8,0,0
217610512,SomaliWarMnt,SomaliWarMnt,1,0,1,1,8,0,0
191822106,NCaucasusCaucus,NCaucasusCaucus,1,0,1,1,8,0,0
2261055875,JundAllah24_7,JundAllah24_7,1,1,0,1,8,0,0.05029272
242907583,dr_haroush,dr_haroush,1,0,2,2,8,0.5,0
266762699,abuobaida89,abuobaida89,1,0,1,1,8,0,0
353040882,arisroussinos,arisroussinos,1,1,3,4,8,0.8333333,0.048934752
2294348347,shaaml,shaaml,1,0,1,1,8,0,0
1337424482,ravOne7,ravOne7,1,1,0,1,8,0,0.05029272
565475974,msimamowakweli,msimamowakweli,1,3,1,4,8,0.25,0.025058063
2770664091,Abu_Umar8246,Abu_Umar8246,1,3,3,6,8,0.41666666,0.063531114
166754998,deolhonajihad,deolhonajihad,1,0,1,1,8,0,0
522746594,abul_fozol,abul_fozol,1,0,1,1,8,0,0
2250308353,Amatullah1islam,Amatullah1islam,1,2,1,3,8,1,0.083684313
2776432465,ansarnews111,ansarnews111,1,0,2,2,8,0.5,0
20511771,VinnieoDowd,VinnieoDowd,1,2,0,2,8,1,0.06075442
2427485323,archicivilians,archicivilians,1,0,2,2,8,0.5,0
1352236206,RafiuMuhammad,RafiuMuhammad,1,1,1,2,8,0,0.05029272
1691614410,revertjannah82,revertjannah82,1,1,0,1,8,0,0.05029272
1685552336,AlFarooqGear,AlFarooqGear,1,1,1,2,8,0,0.05029272
2830269676,Shickenz,Shickenz,1,4,0,4,8,0.75,0.118857029
283966733,BWarHead,BWarHead,1,1,0,1,8,0,0.05029272
423662810,TheAnonMessage,TheAnonMessage,1,0,1,1,8,0,0
2780069180,anu_rachu,anu_rachu,1,2,0,2,8,1,0.083684313
58064240,islamawakening,islamawakening,1,0,1,1,8,0,0
2398518691,muslimsalafi34,muslimsalafi34,1,1,1,2,8,0,0.05029272
326991289,AlakhbarEnglish,AlakhbarEnglish,1,0,1,1,8,0,0
1077181999,arabthomness,arabthomness,1,0,1,1,8,0,0
290061912,AlMonitor,AlMonitor,1,0,1,1,8,0,0
2717187718,HVardarli,HVardarli,1,1,0,1,8,0,0.05029272
2838953701,alsahab9988,alsahab9988,1,0,2,2,8,0.5,0
872185597,GettySport,GettySport,1,0,1,1,8,0,0
2390687538,green_lemonnn,green_lemonnn,1,0,1,1,8,0,0
2228573491,mohammad_siddik,mohammad_siddik,1,1,0,1,8,0,0.05029272
1059061597,Snafialnasr,Snafialnasr,1,0,3,3,8,0.8333333,0
2794782585,as_ansar3,as_ansar3,1,0,2,2,8,0.5,0
201162725,rahimiosman,rahimiosman,1,1,0,1,8,0,0.05029272
2825912327,Hakki_var,Hakki_var,1,2,0,2,7,0.5,0.052704998
19103793,annaholligan,annaholligan,1,1,0,1,7,0,0.003770246
2570748046,MoChewy1,MoChewy1,1,0,1,1,7,0,0
2788458647,SUM4YY4H96,SUM4YY4H96,1,1,0,1,7,0,0.003770246
1384480956,ahkhoso,ahkhoso,1,1,0,1,7,0,0.003770246
1583743202,LoveSpecKay,LoveSpecKay,1,1,0,1,7,0,0.003770246
2712240376,1Abumuslim,1Abumuslim,1,1,0,1,7,0,0.003770246
2411233532,baghdadi_baker,baghdadi_baker,1,2,0,2,7,0,0.03716184
155189544,QURANPROJECTorg,QURANPROJECTorg,1,0,1,1,7,0,0
2794848564,picus_tv,picus_tv,1,1,0,1,7,0,0.003770246
2575499575,BJP_Official,BJP_Official,1,2,1,3,7,0.5,0.052704998
311722316,Cihadi_Selefi,Cihadi_Selefi,1,2,0,2,7,0.5,0.052704998
2251719092,Khrdhaniaa,Khrdhaniaa,1,2,0,2,7,0,0.028481261
387973563,Sneeuwpop12345,Sneeuwpop12345,1,2,1,3,7,0.5,0.052704998
951091682,Sello786,Sello786,1,1,0,1,7,0,0.003770246
2761851405,tasnifdisi00,tasnifdisi00,1,2,0,2,7,0.5,0.052704998
50113300,sisoni36,sisoni36,1,1,0,1,7,0,0.003770246
1289388740,Ravahah,Ravahah,1,3,0,3,7,0.5,0.086096591
1009844959,AhmedMde,AhmedMde,1,1,0,1,7,0,0.003770246
2448687840,HasnalFilipini,HasnalFilipini,1,1,1,2,7,0.5,0.003770246
2776826600,IsisInSeason,IsisInSeason,1,3,0,3,7,0.5,0.086096591
1205507563,DieguezFran,DieguezFran,1,1,0,1,7,0,0.003770246
2508555146,alkashmiri34,alkashmiri34,1,1,0,1,7,0,0.003770246
2805334964,AmberCatalina1,AmberCatalina1,1,1,0,1,7,0,0.003770246
172458937,perfumos,perfumos,1,1,0,1,7,0,0.003770246
2782495676,sjhd14,sjhd14,1,1,0,1,7,0,0.003770246
1421312990,citizen_heaven,citizen_heaven,1,1,0,1,7,0,0.003770246
25986049,nivva,nivva,1,2,0,2,7,0.5,0.052704998
153322542,Hazothazot,Hazothazot,1,1,0,1,7,0,0.003770246
2768897077,AnsaruKhilafah,AnsaruKhilafah,1,2,0,2,7,0.5,0.052704998
401409078,Nasri_Islaam,Nasri_Islaam,1,2,0,2,7,0.5,0.052704998
2865169466,deen9216,deen9216,1,1,0,1,7,0,0.003770246
1160578130,maliknaasi,maliknaasi,1,1,0,1,7,0,0.003770246
2407203948,HummHumma,HummHumma,1,2,0,2,7,0,0.014231947
290292870,Ebola_Sux,Ebola_Sux,1,1,0,1,7,0,0.003770246
166855887,darbywoutj,darbywoutj,1,1,0,1,7,0,0.003770246
2213283110,butirdebu_,butirdebu_,1,1,0,1,7,0,0.003770246
2565047647,muscabyare120,muscabyare120,1,3,0,3,7,0.33333334,0.063166699
2188412384,sippey_007,sippey_007,1,5,0,5,7,0.5,0.121269307
367756800,Abu_Umar_Ulvi,Abu_Umar_Ulvi,1,1,0,1,7,0,0.003770246
2604795489,ksh_mo,ksh_mo,1,1,0,1,7,0,0.003770246
52889362,omer812,omer812,1,1,0,1,7,0,0.003770246
955647812,Majid_Afshar,Majid_Afshar,1,1,0,1,7,0,0.003770246
2580252509,ghareebman14,ghareebman14,1,2,1,3,7,0.5,0.052704998
2735540127,abumusa_britani,abumusa_britani,1,1,0,1,7,0,0.003770246
2769324069,AkhLampost,AkhLampost,1,3,0,3,7,0.5,0.086096591
788524,guardiannews,guardiannews,1,0,2,2,7,0,0
2610730676,Tabiullah313,Tabiullah313,1,3,0,3,7,0.5,0.077416012
2565245046,Troll__Olol,Troll__Olol,1,1,0,1,7,0,0.003770246
2597095544,AmberKristen1,AmberKristen1,1,1,0,1,7,0,0.003770246
2781186208,andesh82,andesh82,1,1,1,2,7,0,0.003770246
2590214491,AbuJabir_1,AbuJabir_1,1,4,0,4,7,0.41666666,0.087877713
2807237000,99927Khan,99927Khan,1,1,0,1,7,0,0.003770246
2491386289,SahaabatuSayf,SahaabatuSayf,1,2,0,2,7,0,0.014231947
33680460,bello_muhammad,bello_muhammad,1,1,0,1,7,0,0.003770246
2821949899,hammerofallah,hammerofallah,1,4,0,4,7,0.5,0.096558292
46991897,QtheUntouchable,QtheUntouchable,1,1,0,1,7,0,0.003770246
2409988535,emhafs1997,emhafs1997,1,1,0,1,7,0,0.003770246
2417035861,MusabYare,MusabYare,1,1,0,1,7,0,0.003770246
2864089706,cihada_davet,cihada_davet,1,1,0,1,7,0,0.003770246
1168738938,nasiib_badan,nasiib_badan,1,1,0,1,7,0,0.003770246
2829617816,DyranCali,DyranCali,1,3,0,3,7,0.5,0.063531114
2746419880,Musa570,Musa570,1,1,0,1,7,0,0.003770246
471141045,Muhammad_3232,Muhammad_3232,1,3,0,3,7,0.5,0.086096591
1066142437,Jannah4714,Jannah4714,1,1,0,1,7,0,0.003770246
329091899,eric4Yeshua,eric4Yeshua,1,2,0,2,7,0,0.03716184
84380499,acher1_kc,acher1_kc,1,1,0,1,7,0,0.003770246
2616429421,AbdBaar,AbdBaar,1,2,0,2,7,0.5,0.052704998
252775305,JohnMatthewHall,JohnMatthewHall,1,3,0,3,7,0.33333334,0.063166699
2668326044,sulfikor,sulfikor,1,2,0,2,7,0,0.028481261
2539476822,keepzia,keepzia,1,1,0,1,7,0,0.003770246
876121146,ThatRareArab,ThatRareArab,1,1,0,1,7,0,0.003770246
376409167,KenneyMkenney,KenneyMkenney,1,1,0,1,7,0,0.003770246
2778762413,mediaISfake1,mediaISfake1,1,3,0,3,7,0.33333334,0.063166699
2731838654,salman1986ashr1,salman1986ashr1,1,1,0,1,7,0,0.003770246
2810023126,UmmStranger,UmmStranger,1,2,0,2,7,0.5,0.052704998
2271972593,SayyidQutb1,SayyidQutb1,1,0,3,3,7,0.33333334,0
2743635191,stranger92_,stranger92_,1,1,0,1,7,0,0.003770246
2749500670,ilaydae778,ilaydae778,1,2,0,2,7,0.5,0.052704998
909643038,BenjaminGhazi,BenjaminGhazi,1,1,0,1,7,0,0.003770246
188110728,KhoderSoueid,KhoderSoueid,1,2,0,2,7,0.5,0.052704998
14224719,Number10gov,Number10gov,1,0,1,1,7,0,0
2799144282,azizidrissa,azizidrissa,1,1,0,1,7,0,0.003770246
592579944,ttpisis,ttpisis,1,2,0,2,7,0.5,0.052704998
277286251,joseph0285,joseph0285,1,1,0,1,7,0,0.003770246
173804947,theonemee,theonemee,1,1,0,1,7,0,0.003770246
2265386510,UmmuAin88,UmmuAin88,1,2,0,2,7,0,0.03716184
2754285097,Muwahidah23,Muwahidah23,1,1,0,1,7,0,0.003770246
2757463677,BouncyBatata,BouncyBatata,1,1,0,1,7,0,0.003770246
1414794936,Suleimandadacha,Suleimandadacha,1,2,0,2,7,0,0.03716184
2751991548,rblegasi85,rblegasi85,1,3,0,3,7,0.5,0.086096591
2314637387,karasancak34,karasancak34,1,1,0,1,7,0,0.003770246
1223037013,Masoom_Mujahid,Masoom_Mujahid,1,7,1,8,7,0.45238096,0.182388142
440504412,drashraf89,drashraf89,1,1,0,1,7,0,0.003770246
1871384676,reporter200,reporter200,1,1,0,1,7,0,0.003770246
2766606581,RyRashidi,RyRashidi,1,1,0,1,7,0,0.003770246
2649264410,tofail805010,tofail805010,1,1,0,1,7,0,0.003770246
479412983,AhmedAadah,AhmedAadah,1,1,0,1,7,0,0.003770246
469391446,talid21,talid21,1,1,0,1,7,0,0.003770246
410489367,ehtesham009,ehtesham009,1,1,0,1,7,0,0.003770246
2566263374,MMadeeq,MMadeeq,1,1,0,1,7,0,0.003770246
2691207764,IbnQahtani,IbnQahtani,1,1,0,1,7,0,0.003770246
50696829,AbuSobrie,AbuSobrie,1,4,0,4,7,0.33333334,0.072334555
2619576968,Restorer99,Restorer99,1,4,0,4,7,0.41666666,0.087877713
2765886115,MaldeefiWitness,MaldeefiWitness,1,3,0,3,7,0.5,0.086096591
18682588,AdilahIlhamm,AdilahIlhamm,1,1,0,1,7,0,0.003770246
2620461812,kifaahh,kifaahh,1,4,0,4,7,0.33333334,0.073992814
2603619084,Ashab1204,Ashab1204,1,1,0,1,7,0,0.003770246
20583237,makiwa,makiwa,1,2,1,3,7,0,0.03716184
2794623927,skafisti2,skafisti2,1,2,0,2,7,0.5,0.052704998
2570294295,Angenita_Tweets,Angenita_Tweets,1,1,0,1,7,0,0.003770246
2831848574,battop12,battop12,1,1,0,1,7,0,0.003770246
742143,BBCWorld,BBCWorld,1,0,3,3,7,0.5,0
79729801,singharj,singharj,1,1,0,1,7,0,0.003770246
2784695456,1btd23,1btd23,1,1,0,1,7,0,0.003770246
373757102,victory4islam,victory4islam,1,2,0,2,7,0.5,0.052704998
1324848379,Jasim_Jasoomi,Jasim_Jasoomi,1,2,0,2,7,0,0.054062966
1307874559,billyro24843627,billyro24843627,1,1,0,1,7,0,0.003770246
188650770,allahuakbar65,allahuakbar65,1,1,0,1,7,0,0.003770246
2299326002,hydaral,hydaral,1,2,1,3,7,0.5,0.052704998
2157450550,chirchirrashid,chirchirrashid,1,1,0,1,7,0,0.003770246
2786956615,vivitit033,vivitit033,1,1,0,1,7,0,0.003770246
19010977,Ateey,Ateey,1,1,0,1,7,0,0.003770246
2710312362,shaadoow01,shaadoow01,1,1,0,1,7,0,0.003770246
510137789,angeloyoung_,angeloyoung_,1,1,0,1,7,0,0.003770246
2457179588,ozkankgn,ozkankgn,1,1,0,1,7,0,0.003770246
577213956,SimonCarr8,SimonCarr8,1,1,0,1,7,0,0.003770246
574428690,Murshad007,Murshad007,1,1,0,1,7,0,0.003770246
1468143144,_osama0_,_osama0_,1,2,0,2,7,0.5,0.052704998
2604340782,PanduanSirat,PanduanSirat,1,1,0,1,7,0,0.003770246
2724861487,frogflaps1965,frogflaps1965,1,1,0,1,7,0,0.003770246
2383648337,Abu_Yasien,Abu_Yasien,1,2,0,2,7,0.5,0.052704998
2829588102,alzarqawi622,alzarqawi622,1,2,0,2,7,0.5,0.052704998
2486998665,greenbird786786,greenbird786786,1,1,0,1,7,0,0.003770246
2364446359,Al_Jazairy,Al_Jazairy,1,2,0,2,7,0,0.014231947
608868019,Majer11,Majer11,1,2,0,2,7,0.5,0.052704998
2807142068,ethio_manf44,ethio_manf44,1,1,0,1,7,0,0.003770246
2660865780,b185a6857d1b443,b185a6857d1b443,1,1,0,1,7,0,0.003770246
2753304319,Tejro2,Tejro2,1,1,0,1,7,0,0.003770246
381786025,inKurdistan,inKurdistan,1,0,1,1,7,0,0
202184748,YounusRSA,YounusRSA,1,4,0,4,7,0.41666666,0.088242128
2587203675,Homad0s,Homad0s,1,2,0,2,7,0.5,0.052704998
21600348,Djihad_analysis,Djihad_analysis,1,2,0,2,7,0,0.03716184
51812460,SlaveofAllah045,SlaveofAllah045,1,2,0,2,7,0.5,0.052704998
192682116,GiannaToboni,GiannaToboni,1,1,0,1,7,0,0.003770246
2731219125,haroon_cajee,haroon_cajee,1,1,0,1,7,0,0.003770246
455710915,ishaqabubakar95,ishaqabubakar95,1,1,0,1,7,0,0.003770246
2799671542,DutnS,DutnS,1,1,0,1,7,0,0.003770246
222861596,iKhanHaripur,iKhanHaripur,1,1,0,1,7,0,0.003770246
29825334,ccpb101,ccpb101,1,1,0,1,7,0,0.003770246
2753075515,ISBaqiah1,ISBaqiah1,1,2,0,2,7,0.5,0.052704998
462062646,khaibar_khaibar,khaibar_khaibar,1,1,0,1,7,0,0.003770246
2787580415,taurus965b,taurus965b,1,3,0,3,7,0.5,0.086096591
1595611670,sabr1409,sabr1409,1,2,0,2,7,0.5,0.052704998
112712116,ZorroAsura,ZorroAsura,1,1,0,1,7,0,0.003770246
2717358690,AbuAnasAlsudani,AbuAnasAlsudani,1,3,0,3,7,0.5,0.086096591
2772867762,mhadsMYTH,mhadsMYTH,1,2,0,2,7,0,0.03716184
257530703,dammit_chloe,dammit_chloe,1,2,0,2,7,0.5,0.052704998
2596679485,ibnkitaab,ibnkitaab,1,2,0,2,7,0.5,0.052704998
2382764917,Asmabintyazid,Asmabintyazid,1,1,0,1,7,0,0.003770246
1886100367,Smka10,Smka10,1,1,0,1,7,0,0.003770246
1158061004,ToKhilafah,ToKhilafah,1,1,0,1,7,0,0.003770246
2606341079,ddodson77641,ddodson77641,1,2,0,2,7,0.5,0.052704998
2625838080,DhuibiWael,DhuibiWael,1,2,0,2,7,0.5,0.052704998
2797476884,sosobatawy,sosobatawy,1,1,0,1,7,0,0.003770246
417078339,Dralamoudy,Dralamoudy,1,3,0,3,7,0.33333334,0.063166699
2778602624,fly_drag,fly_drag,1,1,0,1,7,0,0.003770246
272473270,CurlyEnas,CurlyEnas,1,1,0,1,7,0,0.003770246
2581011755,abumuslim31,abumuslim31,1,4,0,4,7,0.33333334,0.072334555
2744753453,1abumohammad,1abumohammad,1,1,0,1,7,0,0.003770246
2417597756,raditia66,raditia66,1,2,0,2,7,0.5,0.052704998
2574687623,RizwanSn7,RizwanSn7,1,1,0,1,7,0,0.003770246
2167512498,Abunizar08,Abunizar08,1,3,0,3,7,0.33333334,0.063166699
2321751539,dinkesadink,dinkesadink,1,2,0,2,7,0,0.03716184
602218072,SuPeR_MaRiO914,SuPeR_MaRiO914,1,1,0,1,7,0,0.003770246
61611674,FlorianFlade,FlorianFlade,1,2,0,2,7,0.5,0.052704998
523017958,Liber8Estonia,Liber8Estonia,1,1,0,1,7,0,0.003770246
1905139472,arsenalreborn,arsenalreborn,1,1,0,1,7,0,0.003770246
42508097,cfwesenberg,cfwesenberg,1,1,0,1,7,0,0.003770246
1636212602,Diazcavalera,Diazcavalera,1,1,0,1,7,0,0.003770246
2821365767,minztee1,minztee1,1,3,0,3,7,0.5,0.077416012
113483807,t_abatan,t_abatan,1,1,0,1,7,0,0.003770246
2793709623,Alwisse1,Alwisse1,1,2,0,2,7,0.5,0.052704998
2669944904,lucamore84,lucamore84,1,1,0,1,7,0,0.003770246
2741903493,I_Love_Foo00D,I_Love_Foo00D,1,2,0,2,7,0,0.014231947
2751766669,007Mansor,007Mansor,1,1,0,1,7,0,0.003770246
2599297171,Ismail_al_turki,Ismail_al_turki,1,2,0,2,7,0.5,0.052704998
301473969,Maryamtahira1,Maryamtahira1,1,4,0,4,7,0.5,0.110807606
2744656058,m_moshriqsex,m_moshriqsex,1,1,0,1,7,0,0.003770246
2780504285,LionsPunjabi,LionsPunjabi,1,1,0,1,7,0,0.003770246
2397741284,Wcr27,Wcr27,1,1,0,1,7,0,0.003770246
2674368760,abu_mas3ood,abu_mas3ood,1,2,0,2,7,0.5,0.052704998
2717557008,dijlahwaalfurat,dijlahwaalfurat,1,1,0,1,7,0,0.003770246
2716836199,behnam_badali,behnam_badali,1,1,0,1,7,0,0.003770246
187244997,adizek,adizek,1,1,0,1,7,0,0.003770246
2574557654,3adam333,3adam333,1,1,0,1,7,0,0.003770246
1724391900,Political_Dr,Political_Dr,1,1,0,1,7,0,0.003770246
140222976,connellyandrew,connellyandrew,1,1,0,1,7,0,0.003770246
2713133569,_BritishBird_,_BritishBird_,1,4,0,4,7,0.5,0.096558292
38675022,isabelhunter,isabelhunter,1,1,0,1,7,0,0.003770246
2599723634,shaykhalarabia,shaykhalarabia,1,2,0,2,7,0,0.03716184
2789319344,SungareeKhan,SungareeKhan,1,2,0,2,7,0.5,0.052704998
2726830798,ComRahmaty,ComRahmaty,1,1,0,1,7,0,0.003770246
2736104195,dawla_umar,dawla_umar,1,1,0,1,7,0,0.003770246
291152644,KurtPelda,KurtPelda,1,1,0,1,7,0,0.003770246
2806850396,mmm003133,mmm003133,1,1,0,1,7,0,0.003770246
2807145399,ATHIATORISER,ATHIATORISER,1,1,0,1,7,0,0.003770246
2757174219,AbuZakariyyeh,AbuZakariyyeh,1,1,1,2,7,0,0.010461701
469148643,JakeDerman,JakeDerman,1,1,0,1,7,0,0.003770246
140190725,Sumera_B,Sumera_B,1,1,0,1,7,0,0.003770246
452076589,SaifUllah313,SaifUllah313,1,1,0,1,7,0,0.003770246
2647041116,lambohuracan,lambohuracan,1,3,0,3,7,0.33333334,0.063166699
595076199,AmmarJenkeezKha,AmmarJenkeezKha,1,1,0,1,7,0,0.003770246
2570331301,RHA1991,RHA1991,1,3,0,3,7,0.5,0.086096591
2347574473,ZaMishiranuHito,ZaMishiranuHito,1,1,0,1,7,0,0.003770246
383329535,NikitoArt,NikitoArt,1,1,0,1,7,0,0.003770246
2739938648,focusONakhira,focusONakhira,1,2,0,2,7,0.5,0.052704998
1056005011,BobakrOsamasCub,BobakrOsamasCub,1,1,0,1,7,0,0.003770246
414623095,S276SB,S276SB,1,2,0,2,7,0.5,0.052704998
359966111,Eeyuup,Eeyuup,1,2,0,2,7,0.5,0.052704998
2729321995,Ase_One,Ase_One,1,3,0,3,7,0.5,0.063531114
2851710523,1truthseeker20,1truthseeker20,1,2,0,2,7,0.5,0.052704998
103065157,David_Cameron,David_Cameron,1,0,1,1,7,0,0
106997390,nishaj_ma,nishaj_ma,1,2,0,2,7,0,0.028481261
2595006146,ConcerndMuslim2,ConcerndMuslim2,1,1,0,1,7,0,0.003770246
19539680,Georg_Heil,Georg_Heil,1,1,0,1,7,0,0.003770246
2751932143,BZOIHLKefskhRbf,BZOIHLKefskhRbf,1,1,0,1,7,0,0.003770246
2319525667,BLXTNT119,BLXTNT119,1,1,0,1,7,0,0.003770246
468363086,adfianadrian,adfianadrian,1,2,0,2,7,0.5,0.052704998
618407763,CiliAlban,CiliAlban,1,4,0,4,7,0.33333334,0.072334555
2739119961,Fogart135,Fogart135,1,1,0,1,7,0,0.003770246
25733072,iamnerves,iamnerves,1,1,0,1,7,0,0.003770246
2811570181,ibraheemahmad00,ibraheemahmad00,1,1,0,1,7,0,0.003770246
1591155721,NVernes,NVernes,1,1,0,1,7,0,0.003770246
2744037727,Strive4Deen_,Strive4Deen_,1,3,0,3,7,0.5,0.086096591
2767671413,Abu_luqmaan_Is,Abu_luqmaan_Is,1,1,0,1,7,0,0.003770246
2673089557,JasmineJhiad,JasmineJhiad,1,2,0,2,7,0,0.03716184
1570449558,Kasra_Shah,Kasra_Shah,1,1,0,1,7,0,0.003770246
2770282677,mdbrown12350,mdbrown12350,1,1,0,1,7,0,0.003770246
63023299,deltalima21,deltalima21,1,1,0,1,7,0,0.003770246
1001171148,darul_ilm,darul_ilm,1,1,0,1,7,0,0.003770246
25402419,JaneDodgeC4,JaneDodgeC4,1,2,0,2,7,0,0.014231947
361867605,C_Kingdon,C_Kingdon,1,2,0,2,7,0,0.028481261
2808981888,ansaruttawheed,ansaruttawheed,1,3,0,3,7,0.5,0.086096591
2830018971,dumanliova,dumanliova,1,1,0,1,7,0,0.003770246
736406119,MirAli09,MirAli09,1,2,0,2,7,0.5,0.052704998
1682582172,UralKarakas,UralKarakas,1,1,0,1,7,0,0.003770246
88517311,WilliamMacleanR,WilliamMacleanR,1,1,0,1,7,0,0.003770246
2366745380,NMHalif,NMHalif,1,1,0,1,7,0,0.003770246
421341995,Salamah_Al_Akwa,Salamah_Al_Akwa,1,2,1,3,7,0.5,0.052704998
2724997936,indaas1,indaas1,1,1,0,1,7,0,0.003770246
1477880630,Barcode20,Barcode20,1,1,0,1,7,0,0.003770246
309734255,MatRockJiRat,MatRockJiRat,1,2,0,2,7,0.5,0.052704998
233515912,bappi48,bappi48,1,1,0,1,7,0,0.003770246
555381228,hansodk,hansodk,1,1,0,1,7,0,0.003770246
2154441645,HalieSheikh,HalieSheikh,1,3,1,4,7,0.5,0.086096591
375479460,A_abdAllah9,A_abdAllah9,1,2,0,2,7,0.5,0.052704998
2825038811,wallpayout,wallpayout,1,1,0,1,7,0,0.003770246
2716806165,ShasmeenW,ShasmeenW,1,2,0,2,7,0.5,0.052704998
2809879730,abdullahlevall1,abdullahlevall1,1,2,0,2,7,0,0.03716184
2809344526,insightlight1,insightlight1,1,1,0,1,7,0,0.003770246
2429594763,Muhajir35,Muhajir35,1,2,0,2,7,0,0.014231947
2754391183,samlawson1000,samlawson1000,1,1,0,1,7,0,0.003770246
905391278,elafrahmani,elafrahmani,1,1,0,1,7,0,0.003770246
2725686463,bobidi008,bobidi008,1,2,0,2,7,0.5,0.052704998
877767896,Faaiz_x786x,Faaiz_x786x,1,1,0,1,7,0,0.003770246
2606869740,asmabintabubak7,asmabintabubak7,1,2,0,2,7,0.5,0.052704998
2636066036,sambokrekok,sambokrekok,1,1,0,1,7,0,0.003770246
1709812987,davidmerfieId,davidmerfieId,1,1,0,1,7,0,0.003770246
2773265742,CrooningLoud,CrooningLoud,1,1,0,1,7,0,0.003770246
64957784,ZeRuBeuS,ZeRuBeuS,1,1,0,1,7,0,0.003770246
2213457248,amirkhattop,amirkhattop,1,1,0,1,7,0,0.003770246
588885350,ShiraxM,ShiraxM,1,1,0,1,7,0,0.003770246
358952300,ruwyscrewy,ruwyscrewy,1,1,0,1,7,0,0.003770246
28093810,Clay1016,Clay1016,1,2,0,2,7,0,0.028481261
18984309,Achel7ey,Achel7ey,1,1,0,1,7,0,0.003770246
148876678,kabbasii,kabbasii,1,1,0,1,7,0,0.003770246
628567492,superjude81,superjude81,1,1,0,1,7,0,0.003770246
2726079966,salman055812323,salman055812323,1,1,0,1,7,0,0.003770246
2816978549,PaulaKassig,PaulaKassig,1,2,0,2,7,0.5,0.052704998
294235867,billelfumigene,billelfumigene,1,2,0,2,7,0,0.028481261
395423453,donidonixxx,donidonixxx,1,1,0,1,7,0,0.003770246
563490573,SBR_GMYL,SBR_GMYL,1,1,0,1,7,0,0.003770246
390934333,peshm3rga,peshm3rga,1,2,0,2,7,0,0.028481261
108539733,Shaykhhh,Shaykhhh,1,1,0,1,7,0,0.003770246
2610573265,AbuMuafa,AbuMuafa,1,1,0,1,7,0,0.003770246
41103393,EliasSaif,EliasSaif,1,1,0,1,7,0,0.003770246
2740858967,fm1683,fm1683,1,3,0,3,7,0.16666667,0.039307377
1081913460,young_islam,young_islam,1,3,0,3,7,0.33333334,0.063166699
2432840384,buang_rashid,buang_rashid,1,1,0,1,7,0,0.003770246
2794827955,AbuAmeenah1435,AbuAmeenah1435,1,1,0,1,7,0,0.003770246
50933958,zulfikar71,zulfikar71,1,1,0,1,7,0,0.003770246
2640752867,AbdulRa24304771,AbdulRa24304771,1,1,0,1,7,0,0.003770246
2738696530,SadinAlsabit,SadinAlsabit,1,1,0,1,7,0,0.003770246
2812916071,alandalusi_91,alandalusi_91,1,1,0,1,7,0,0.003770246
119026050,jdhalevi,jdhalevi,1,4,0,4,7,0.5833333,0.136389311
2795876768,outnumbered313,outnumbered313,1,1,0,1,7,0,0.003770246
459911679,OumDeg1,OumDeg1,1,2,0,2,7,0.5,0.052704998
2722705939,shadowpeoplez,shadowpeoplez,1,1,0,1,7,0,0.003770246
2615915029,kawatim1,kawatim1,1,1,0,1,7,0,0.003770246
2799656389,marauderm46,marauderm46,1,5,0,5,7,0.5,0.121269307
256357031,shihanudeen,shihanudeen,1,1,0,1,7,0,0.003770246
2815242981,JamilPilot,JamilPilot,1,2,0,2,7,0,0.03716184
378680084,Ahmath_Rihan,Ahmath_Rihan,1,1,0,1,7,0,0.003770246
1497936764,NazarTheboss,NazarTheboss,1,3,0,3,7,0.5,0.077416012
2752033663,IndianMujahid,IndianMujahid,1,1,0,1,7,0,0.003770246
2665405931,almagrami22,almagrami22,1,3,0,3,7,0.5,0.086096591
1446884394,M_Afzal92,M_Afzal92,1,2,0,2,7,0.5,0.014596362
2646684790,zimmy_87,zimmy_87,1,1,0,1,7,0,0.003770246
2211493058,OrigionalPickup,OrigionalPickup,1,1,0,1,7,0,0.003770246
167687392,umarhanif,umarhanif,1,2,0,2,7,0,0.014231947
39171398,haydencooper,haydencooper,1,1,0,1,7,0,0.003770246
2796270939,abusayf99,abusayf99,1,2,0,2,7,0,0.028481261
2490840412,nverloosefocus,nverloosefocus,1,1,0,1,7,0,0.003770246
2387359076,tariqkmuj,tariqkmuj,1,3,0,3,7,0.5,0.086096591
226440557,susy80s,susy80s,1,3,0,3,7,0.5,0.086096591
2615129479,abdallaalhurani,abdallaalhurani,1,3,0,3,7,0.5,0.086096591
2509846028,denis_nafa,denis_nafa,1,1,0,1,7,0,0.003770246
2785359461,PathOfHaqq,PathOfHaqq,1,2,0,2,7,0.5,0.052704998
608220854,badru_417,badru_417,1,1,0,1,7,0,0.003770246
2807936749,AbuSayaf1995,AbuSayaf1995,1,1,0,1,7,0,0.003770246
2645014267,AmoTwalha,AmoTwalha,1,1,0,1,7,0,0.003770246
2302359345,MagribiWitness,MagribiWitness,1,0,1,1,7,0,0
1652541,Reuters,Reuters,1,0,3,3,7,0.5,0
164673361,Fatoxbrox,Fatoxbrox,1,4,0,4,7,0.5,0.096558292
2713532254,alka3ka3O,alka3ka3O,1,1,0,1,7,0,0.003770246
1264138136,zakariya1996,zakariya1996,1,2,2,4,7,0.16666667,0.028481261
338573209,iDesireJannah,iDesireJannah,1,1,0,1,7,0,0.003770246
2213296066,saadkaaf,saadkaaf,1,1,0,1,7,0,0.003770246
2798696408,a_7mzah2,a_7mzah2,1,2,0,2,7,0,0.03716184
2767370259,madega_issa,madega_issa,1,1,0,1,7,0,0.003770246
2773137428,akuraharjo,akuraharjo,1,2,0,2,7,0.5,0.052704998
2604463109,augustus_mag,augustus_mag,1,1,0,1,7,0,0.003770246
2367371419,_qubbaj,_qubbaj,1,1,0,1,7,0,0.003770246
2290170044,AssadAlHarb,AssadAlHarb,1,2,0,2,7,0.5,0.052704998
760002865,Adamzizy,Adamzizy,1,1,0,1,7,0,0.003770246
2767731013,Sarah4892,Sarah4892,1,1,0,1,7,0,0.003770246
2832430138,al_muwahideen,al_muwahideen,1,2,0,2,7,0.5,0.014596362
2635807112,rogue_allah,rogue_allah,1,2,0,2,7,0,0.054062966
1879095696,Abu_Muthana,Abu_Muthana,1,1,0,1,7,0,0.003770246
1673869788,sunny_sano,sunny_sano,1,2,0,2,7,0.5,0.052704998
2851682790,UmmMuhammad73,UmmMuhammad73,1,2,0,2,7,0.5,0.014596362
25704960,Vittek,Vittek,1,3,0,3,7,0.16666667,0.039307377
2840312340,mujahida28,mujahida28,1,1,0,1,7,0,0.003770246
41073224,lutfiabuaun,lutfiabuaun,1,1,0,1,7,0,0.003770246
270940980,aljar7y,aljar7y,1,1,0,1,7,0,0.003770246
121631891,mikhaelfiraz,mikhaelfiraz,1,1,0,1,7,0,0.003770246
2771205033,UmmiSaalihah,UmmiSaalihah,1,3,0,3,7,0.5,0.063531114
2350103498,miss_ravat,miss_ravat,1,2,0,2,7,0.5,0.014596362
2743221305,4dbpU4i8URqwJCK,4dbpU4i8URqwJCK,1,4,0,4,7,0.5,0.096558292
2773630012,soma1i_lion,soma1i_lion,1,0,1,1,7,0,0
2455321718,geek00,geek00,1,1,0,1,7,0,0.003770246
519421168,KatjaMarz,KatjaMarz,1,1,0,1,7,0,0.003770246
1035700783,RevertBilal,RevertBilal,1,0,1,1,7,0,0
2684828993,mehmeta787,mehmeta787,1,3,0,3,7,0.5,0.063531114
2784083309,khalid_bakr111,khalid_bakr111,1,2,0,2,7,0,0.03716184
2676014451,Baaba2againa,Baaba2againa,1,1,0,1,7,0,0.003770246
2589769138,abberar39,abberar39,1,1,0,1,7,0,0.003770246
253675177,AbuZabaniah,AbuZabaniah,1,4,0,4,7,0.5,0.110807606
191512123,azhussian,azhussian,1,2,0,2,7,0,0.03716184
208780911,Conormel,Conormel,1,1,0,1,7,0,0.003770246
2835463794,AbuKhilafa,AbuKhilafa,1,2,0,2,7,0,0.028481261
2770321022,isais61,isais61,1,1,0,1,7,0,0.003770246
2830384767,one_ummaah,one_ummaah,1,1,0,1,7,0,0.003770246
99729024,amiriaz80,amiriaz80,1,3,0,3,7,0.5,0.086096591
547077905,Tawlanita,Tawlanita,1,1,0,1,7,0,0.003770246
2762129220,Benisnasen,Benisnasen,1,1,0,1,7,0,0.003770246
262061897,muhammedbelim,muhammedbelim,1,2,0,2,7,0.5,0.052704998
2500050772,Umm_AlFarouk,Umm_AlFarouk,1,4,0,4,7,0.5,0.113459418
331267956,Amatullah___,Amatullah___,1,1,0,1,7,0,0.003770246
2774482822,matundamussa,matundamussa,1,2,0,2,7,0.5,0.052704998
2707046283,jari_el,jari_el,1,3,0,3,7,0.5,0.086096591
2713763730,tkingdomnews,tkingdomnews,1,1,0,1,7,0,0.003770246
2710847417,mohiemmoka,mohiemmoka,1,1,0,1,7,0,0.003770246
2598297594,Farouk2085,Farouk2085,1,1,0,1,7,0,0.003770246
401490009,ZionistWit,ZionistWit,1,1,0,1,7,0,0.003770246
2358165612,vhanreigndeanne,vhanreigndeanne,1,2,0,2,7,0,0.03716184
2739388617,AjMarketa,AjMarketa,1,1,0,1,7,0,0.003770246
1919566068,SaleemKhayyam,SaleemKhayyam,1,1,0,1,7,0,0.003770246
520831234,ZZeMatador,ZZeMatador,1,1,0,1,7,0,0.003770246
346210618,Nun0z,Nun0z,1,2,0,2,7,0,0.03716184
1539162428,TikTalk2000,TikTalk2000,1,1,0,1,7,0,0.003770246
796639562,abinseif,abinseif,1,1,0,1,7,0,0.003770246
2548220245,amjedunais88,amjedunais88,1,1,0,1,7,0,0.003770246
2471346537,teletabiii,teletabiii,1,0,1,1,7,0,0
2298167662,AsiBajrami1,AsiBajrami1,1,2,0,2,7,0,0.028481261
2814656898,SayfAllahSuri,SayfAllahSuri,1,2,0,2,7,0.5,0.052704998
195248527,Himalaya888,Himalaya888,1,1,0,1,7,0,0.003770246
2584297916,AbuNasirudeen,AbuNasirudeen,1,5,1,6,7,0.5,0.121269307
2618638788,khilafaharmy21,khilafaharmy21,1,1,0,1,7,0,0.003770246
572998163,mm_y182,mm_y182,1,2,0,2,7,0.5,0.052704998
2760688155,specialmuslimah,specialmuslimah,1,2,0,2,7,0.5,0.052704998
2372911681,Sunnah100,Sunnah100,1,2,0,2,7,0.5,0.052704998
2712978011,AlAhmedUk,AlAhmedUk,1,1,0,1,7,0,0.003770246
357417646,AlShaheedBD,AlShaheedBD,1,1,0,1,7,0,0.003770246
2612183766,Abuhafs1345,Abuhafs1345,1,1,0,1,7,0,0.003770246
2569487083,WaitingInBagdad,WaitingInBagdad,1,1,0,1,7,0,0.003770246
2618062294,zahra_8525,zahra_8525,1,1,0,1,7,0,0.003770246
952877870,yaqubfarhad12,yaqubfarhad12,1,1,0,1,7,0,0.003770246
303350661,MajorstuNetwork,MajorstuNetwork,1,1,0,1,7,0,0.003770246
555107276,mas_bems,mas_bems,1,1,0,1,7,0,0.003770246
2769830869,abusawaarim,abusawaarim,1,1,0,1,7,0,0.003770246
2574828528,Muzzzyjabz,Muzzzyjabz,1,2,0,2,7,0.5,0.052704998
1375519770,Baitul_Maqdis,Baitul_Maqdis,1,3,1,4,7,0.33333334,0.063166699
2786903073,IslammUmmah,IslammUmmah,1,1,0,1,7,0,0.003770246
2782151776,abumuhajir19_78,abumuhajir19_78,1,1,0,1,7,0,0.003770246
979158133,mohamma11237580,mohamma11237580,1,1,0,1,7,0,0.003770246
2494252190,1g4usn5uj3h4g3b,1g4usn5uj3h4g3b,1,1,0,1,7,0,0.003770246
1014514950,DiaaMustafa2,DiaaMustafa2,1,1,0,1,7,0,0.003770246
2250655037,alamanjee,alamanjee,1,2,0,2,7,0.5,0.052704998
2600781221,watchpigs,watchpigs,1,2,0,2,7,0.5,0.052704998
2361509287,N00R_ISLAMI,N00R_ISLAMI,1,2,0,2,7,0.5,0.052704998
1436337624,RSeize,RSeize,1,2,1,3,7,0,0.054062966
926402048,EverUmmah,EverUmmah,1,1,0,1,7,0,0.003770246
132466213,asmarani_eye,asmarani_eye,1,1,0,1,7,0,0.003770246
2577974928,jackunlifted,jackunlifted,1,3,0,3,7,0.5,0.077416012
2731132638,proud_muslim7,proud_muslim7,1,1,0,1,7,0,0.003770246
2816657236,ummuAayah,ummuAayah,1,1,0,1,7,0,0.003770246
1607616356,ghostofkashmir,ghostofkashmir,1,0,1,1,7,0,0
2411218802,LennartLimertin,LennartLimertin,1,2,0,2,7,0.5,0.014596362
2712586108,ShahDaKing,ShahDaKing,1,1,0,1,7,0,0.003770246
2811873190,IbnAmghar2,IbnAmghar2,1,5,1,6,7,0.35,0.098703829
2665236450,ShankootyEgypt,ShankootyEgypt,1,1,0,1,7,0,0.003770246
2826848227,Lofty_Mountains,Lofty_Mountains,1,1,0,1,7,0,0.003770246
322357271,Mikepeck1974,Mikepeck1974,1,1,0,1,7,0,0.003770246
21776552,RyanMauro,RyanMauro,1,2,0,2,7,0.5,0.052704998
238504105,demiborong,demiborong,1,2,0,2,7,0.5,0.052704998
2741520575,kamwindo,kamwindo,1,1,0,1,7,0,0.003770246
1883424968,TheNewsHub,TheNewsHub,1,1,0,1,7,0,0.003770246
1027098830,MeidyaYuda,MeidyaYuda,1,2,0,2,7,0,0.03716184
2734967055,DrAbuKhalid1,DrAbuKhalid1,1,3,0,3,7,0.16666667,0.038942962
542984598,HemnMerany,HemnMerany,1,1,0,1,7,0,0.003770246
2773109144,abua7038,abua7038,1,2,0,2,7,0,0.03716184
2850605479,AsadAlMouhajir,AsadAlMouhajir,1,1,0,1,7,0,0.003770246
237783528,HoesLoveMe_Tay,HoesLoveMe_Tay,1,1,0,1,7,0,0.003770246
2793818645,loudhatif,loudhatif,1,3,0,3,7,0.5,0.063531114
2408838920,abu_al_shaymaa,abu_al_shaymaa,1,1,0,1,7,0,0.003770246
1440860724,reu_349,reu_349,1,2,0,2,7,0.5,0.052704998
280939063,suranong,suranong,1,1,0,1,7,0,0.003770246
171428420,ohatab11,ohatab11,1,1,0,1,7,0,0.003770246
2778516065,waqiii1,waqiii1,1,2,0,2,7,0.5,0.052704998
2752694903,AlHornaki,AlHornaki,1,1,0,1,7,0,0.003770246
2782284495,joewavy252,joewavy252,1,1,0,1,7,0,0.003770246
1725254466,zaadalmaad10,zaadalmaad10,1,1,0,1,7,0,0.003770246
414436350,FaizahNasira,FaizahNasira,1,3,0,3,7,0.33333334,0.063166699
2743061516,arok6868,arok6868,1,1,0,1,7,0,0.003770246
1263717428,waseemmir007,waseemmir007,1,3,0,3,7,0.16666667,0.039307377
219630686,3bdUlkaed6r,3bdUlkaed6r,1,2,1,3,7,0.33333334,0.052704998
486788324,Jabinurface,Jabinurface,1,1,0,1,7,0,0.003770246
2816560378,AbuGheerah,AbuGheerah,1,1,0,1,7,0,0.003770246
2731822342,mjamiu78,mjamiu78,1,1,0,1,7,0,0.003770246
2743946594,peace_reporter,peace_reporter,1,4,0,4,7,0.5,0.110807606
21974393,zanzompa,zanzompa,1,1,0,1,7,0,0.003770246
2833370570,Rouleur8,Rouleur8,1,1,0,1,7,0,0.003770246
2765934052,camarasaikou344,camarasaikou344,1,1,0,1,7,0,0.003770246
2820623850,dieselmartin2,dieselmartin2,1,1,0,1,7,0,0.003770246
138202672,Moddymodo,Moddymodo,1,1,0,1,7,0,0.003770246
247516794,jfsci,jfsci,1,1,0,1,7,0,0.003770246
2195443323,amalnouraoum,amalnouraoum,1,1,0,1,7,0,0.003770246
2794606204,FallujahISIS,FallujahISIS,1,2,0,2,7,0.5,0.052704998
244141714,Monshur0920,Monshur0920,1,2,0,2,7,0,0.014231947
2855390960,fatihsulaim,fatihsulaim,1,2,0,2,7,0,0.028481261
110382869,Rusembilan,Rusembilan,1,3,0,3,7,0.33333334,0.063166699
1611714422,FKunushevci,FKunushevci,1,5,0,5,7,0.5,0.121269307
806473614,Omaralfaaruq,Omaralfaaruq,1,2,0,2,7,0.5,0.052704998
2767540115,NazirImran123,NazirImran123,1,1,0,1,7,0,0.003770246
2810204077,inshallahbro,inshallahbro,1,3,0,3,7,0.33333334,0.063166699
2794147768,abububbles1,abububbles1,1,2,0,2,7,0.5,0.052704998
962154494,fasid2006,fasid2006,1,2,0,2,7,0.5,0.052704998
229560326,assmasala,assmasala,1,1,0,1,7,0,0.003770246
2788642834,kalcanadi,kalcanadi,1,1,0,1,7,0,0.003770246
2786381912,abuosamatounssi,abuosamatounssi,1,1,0,1,7,0,0.003770246
2502807650,terryqu64681160,terryqu64681160,1,2,0,2,7,0.5,0.052704998
99340420,Ab3li,Ab3li,1,2,0,2,7,0,0.03716184
2861093078,7804i,7804i,1,2,0,2,7,0.5,0.052704998
254070999,MHR_114,MHR_114,1,1,0,1,7,0,0.003770246
599150814,franz_aka_slim,franz_aka_slim,1,0,1,1,7,0,0
2223722738,PKGM5,PKGM5,1,1,0,1,7,0,0.003770246
267866417,bloomstomb,bloomstomb,1,1,0,1,7,0,0.003770246
308793659,er_ismail86,er_ismail86,1,1,0,1,7,0,0.003770246
295139387,farhan112233,farhan112233,1,1,0,1,7,0,0.003770246
2829144473,abdiahkim93,abdiahkim93,1,1,0,1,7,0,0.003770246
2771210883,pandatank1,pandatank1,1,3,0,3,7,0.5,0.077416012
2261013148,Mohanndeniz,Mohanndeniz,1,2,0,2,7,0,0.028481261
2656293552,Hblqaimpur,Hblqaimpur,1,2,0,2,7,0.5,0.052704998
72241874,Crotard,Crotard,1,1,0,1,7,0,0.003770246
570675976,matheen9,matheen9,1,1,0,1,7,0,0.003770246
1676628793,I_S_O_I,I_S_O_I,1,1,0,1,7,0,0.003770246
356143946,sawthurawin,sawthurawin,1,1,0,1,7,0,0.003770246
2672972704,hayleydavies198,hayleydavies198,1,2,0,2,7,0.5,0.052704998
2793034696,moslimah0909,moslimah0909,1,1,0,1,7,0,0.003770246
18774180,jevdet,jevdet,1,1,0,1,7,0,0.003770246
262491643,kev_mcdonald,kev_mcdonald,1,1,0,1,7,0,0.003770246
1033458739,MrCuntyballs2U,MrCuntyballs2U,1,3,0,3,7,0.33333334,0.063166699
2815546428,NoorAbdullmnoor,NoorAbdullmnoor,1,1,0,1,7,0,0.003770246
2386973901,quranic_inspire,quranic_inspire,1,1,1,2,7,0.5,0.003770246
1461507306,nazrirun,nazrirun,1,1,0,1,7,0,0.003770246
2777544922,johnishere11,johnishere11,1,1,0,1,7,0,0.003770246
2394248485,Sarah29376962,Sarah29376962,1,2,0,2,7,0,0.014231947
171300172,_Amatullah__,_Amatullah__,1,3,0,3,7,0.5,0.063531114
2828948824,saqr_queen,saqr_queen,1,3,0,3,7,0.5,0.063531114
2742572524,Khilafah1435,Khilafah1435,1,0,1,1,7,0,0
2804602371,bintalfarouk3,bintalfarouk3,1,1,0,1,7,0,0.003770246
1092048392,jafra_m,jafra_m,1,1,0,1,7,0,0.003770246
1159452218,MusuhAbadiPB,MusuhAbadiPB,1,2,0,2,7,0.5,0.014596362
39237910,HalaJaber,HalaJaber,1,1,0,1,7,0,0.003770246
1372083883,janice_nawal,janice_nawal,1,2,1,3,7,0.5,0.052704998
146593483,iqy007,iqy007,1,1,0,1,7,0,0.003770246
1627404582,sittnood,sittnood,1,1,0,1,7,0,0.003770246
2809157372,1a_11_a1,1a_11_a1,1,1,0,1,7,0,0.003770246
2444580612,LibanAboud,LibanAboud,1,3,0,3,7,0.33333334,0.04762354
870766363,Prince0Hitch,Prince0Hitch,1,1,0,1,7,0,0.003770246
20666151,sonofbelial,sonofbelial,1,1,0,1,7,0,0.003770246
1413273390,AhmedAzwad,AhmedAzwad,1,2,0,2,7,0.5,0.052704998
174610288,YunusSeedat,YunusSeedat,1,1,0,1,7,0,0.003770246
272127865,lemineoms,lemineoms,1,1,0,1,7,0,0.003770246
29415391,Monicabeek,Monicabeek,1,1,0,1,7,0,0.003770246
2338772976,muhadehad,muhadehad,1,3,0,3,7,0.16666667,0.025058063
2711476242,syedsaif122,syedsaif122,1,2,0,2,7,0.5,0.052704998
2832291859,AK47_SHOOTER,AK47_SHOOTER,1,2,0,2,7,0.5,0.052704998
2733135892,abufirdose,abufirdose,1,1,1,2,7,0,0.003770246
18405412,scribblercat,scribblercat,1,2,0,2,7,0.5,0.052704998
2671007821,LeanbarreSaddam,LeanbarreSaddam,1,2,0,2,7,0.5,0.052704998
496359525,hormonlu_capon,hormonlu_capon,1,1,0,1,7,0,0.003770246
2828392556,enntike,enntike,1,2,0,2,7,0.5,0.052704998
612473,BBCNews,BBCNews,1,0,1,1,7,0,0
2749028562,azusa_is,azusa_is,1,1,0,1,7,0,0.003770246
1043650808,Rawwgoon,Rawwgoon,1,1,0,1,7,0,0.003770246
1255561465,mdxamari,mdxamari,1,1,0,1,7,0,0.003770246
2795694236,MujahidLover69,MujahidLover69,1,1,0,1,7,0,0.003770246
881220001,pauline_tracey,pauline_tracey,1,1,0,1,7,0,0.003770246
733174184,LargeMainboard,LargeMainboard,1,1,0,1,7,0,0.003770246
2809518516,nooriraq105,nooriraq105,1,1,0,1,7,0,0.003770246
50420164,LostSoulnArabia,LostSoulnArabia,1,2,0,2,7,0.5,0.052704998
2595969494,ahmeyney8,ahmeyney8,1,3,0,3,7,0.5,0.086096591
2738018823,22e697a30e7e410,22e697a30e7e410,1,1,0,1,7,0,0.003770246
2700728912,susan0083,susan0083,1,2,0,2,7,0.5,0.052704998
47307516,Meyaam,Meyaam,1,1,0,1,7,0,0.003770246
556030757,muhammedyakub13,muhammedyakub13,1,1,0,1,7,0,0.003770246
2840615816,abduallahiB3,abduallahiB3,1,3,0,3,7,0.5,0.086096591
555474369,omar_moaaz,omar_moaaz,1,1,0,1,7,0,0.003770246
2798476264,mkbaale1,mkbaale1,1,1,0,1,7,0,0.003770246
2717735954,lynsonjerome,lynsonjerome,1,1,0,1,7,0,0.003770246
2833898605,sala7udeen21,sala7udeen21,1,1,0,1,7,0,0.003770246
2779210941,AbdullahEritri,AbdullahEritri,1,1,0,1,7,0,0.003770246
1317035124,Reminder_Tweets,Reminder_Tweets,1,2,0,2,7,0,0.028481261
2766396539,rahman_sumaya,rahman_sumaya,1,1,0,1,7,0,0.003770246
2745818251,b1376e14259746b,b1376e14259746b,1,1,0,1,7,0,0.003770246
407297167,RakanMallak,RakanMallak,1,1,0,1,7,0,0.003770246
1556470987,AyashHamooda,AyashHamooda,1,2,0,2,7,0.5,0.052704998
2703744256,aboequdama,aboequdama,1,1,0,1,7,0,0.003770246
2635455752,jaskasturi,jaskasturi,1,1,0,1,7,0,0.003770246
2713967899,AbdullabinAli8,AbdullabinAli8,1,3,0,3,7,0.5,0.086096591
14933370,diaahadid,diaahadid,1,2,1,3,7,0.5,0.052704998
21388695,abususu,abususu,1,1,0,1,7,0,0.003770246
1367531,FoxNews,FoxNews,1,0,1,1,7,0,0
1075895833,schneepe,schneepe,1,1,0,1,7,0,0.003770246
1059446306,MisuzJ,MisuzJ,1,1,0,1,7,0,0.003770246
2617105993,muhammedmajid11,muhammedmajid11,1,2,0,2,7,0.5,0.052704998
2212690530,OoneAz,OoneAz,1,1,0,1,7,0,0.003770246
328523344,GirlSagubak,GirlSagubak,1,1,0,1,7,0,0.003770246
399391333,UmbertoBacchi,UmbertoBacchi,1,2,0,2,7,0.5,0.052704998
2800377467,AbuIliane,AbuIliane,1,1,0,1,7,0,0.003770246
2814467732,AbuShuyaibHindi,AbuShuyaibHindi,1,1,0,1,7,0,0.003770246
102162231,AllahGreatQuran,AllahGreatQuran,1,0,1,1,7,0,0
1723588417,ibn_somal,ibn_somal,1,1,0,1,7,0,0.003770246
2710396776,lov34ummah,lov34ummah,1,1,0,1,7,0,0.003770246
2620635797,lucsirlatif786,lucsirlatif786,1,1,0,1,7,0,0.003770246
2574475190,RumySharfaraz,RumySharfaraz,1,5,0,5,7,0.5,0.121269307
866050064,aku_hambaMuu,aku_hambaMuu,1,2,0,2,7,0,0.03716184
618913847,Hawlati22,Hawlati22,1,1,0,1,7,0,0.003770246
1958404189,SNizamR,SNizamR,1,2,0,2,7,0.5,0.052704998
973988010,YehyaUmar,YehyaUmar,1,1,0,1,7,0,0.003770246
1718838656,SiPemburuSYAHID,SiPemburuSYAHID,1,2,0,2,7,0.5,0.052704998
910844174,presXL,presXL,1,1,0,1,7,0,0.003770246
933683515,ibnmuzammil,ibnmuzammil,1,3,0,3,7,0.5,0.063531114
2367918154,s_hasan1995,s_hasan1995,1,2,0,2,7,0.5,0.014596362
2541019597,MonteFaye,MonteFaye,1,1,0,1,7,0,0.003770246
2614682095,BbyJae82,BbyJae82,1,2,0,2,7,0.5,0.052704998
2784027147,Abu_Jihad_,Abu_Jihad_,1,3,0,3,7,0.5,0.086096591
230253083,MohaTee01,MohaTee01,1,2,0,2,7,0.5,0.014596362
2365907487,muslimedia30,muslimedia30,1,2,0,2,7,0.5,0.014596362
2794316326,lofty_mountainz,lofty_mountainz,1,1,0,1,7,0,0.003770246
454976062,umar4khalifa,umar4khalifa,1,2,0,2,7,0.5,0.052704998
2418369108,blackbanner313,blackbanner313,1,3,0,3,7,0.33333334,0.04762354
2654823013,maryanndahman,maryanndahman,1,2,0,2,7,0.5,0.052704998
2517099133,Majutak01,Majutak01,1,2,1,3,7,0.5,0.052704998
1035461305,Salaxuden,Salaxuden,1,1,2,3,7,0,0.033391593
7430842,8220Mahmoud,8220Mahmoud,1,1,0,1,7,0,0.003770246
2284380872,Aboubiloubilou,Aboubiloubilou,1,2,0,2,7,0.5,0.052704998
2335105776,AbuMusaBARCAwi,AbuMusaBARCAwi,1,1,0,1,7,0,0.003770246
228156220,GlenWalker92,GlenWalker92,1,1,0,1,7,0,0.003770246
2755781437,serooblood,serooblood,1,1,0,1,7,0,0.003770246
148988795,yudiantobayu,yudiantobayu,1,1,0,1,7,0,0.003770246
2800706486,AyeeeshaB,AyeeeshaB,1,5,0,5,7,0.4,0.121633722
2779571156,Ustekinumab,Ustekinumab,1,3,0,3,7,0.5,0.077416012
177923039,muwalaat,muwalaat,1,1,0,1,7,0,0.003770246
2789762024,barakabaraka12,barakabaraka12,1,1,0,1,7,0,0.003770246
2821252085,fuze2100,fuze2100,1,1,0,1,7,0,0.003770246
260269108,Sha_dw_i,Sha_dw_i,1,1,0,1,7,0,0.003770246
2809756513,albraanas,albraanas,1,1,0,1,7,0,0.003770246
2261148795,FirdawssOum,FirdawssOum,1,1,0,1,7,0,0.003770246
108913872,fkhrzzn,fkhrzzn,1,1,0,1,7,0,0.003770246
2777834714,jjkd123,jjkd123,1,1,0,1,7,0,0.003770246
188343536,RikazGazzaly,RikazGazzaly,1,4,0,4,7,0.41666666,0.087877713
2677236999,pizza1050,pizza1050,1,2,0,2,7,0,0.03716184
2476336418,lokman_aidil,lokman_aidil,1,1,0,1,7,0,0.003770246
2665669962,bicepsofpeace,bicepsofpeace,1,1,0,1,7,0,0.003770246
2749130112,ISISHIVE,ISISHIVE,1,4,1,5,7,0.5,0.096558292
2606392717,m_binqasim,m_binqasim,1,1,0,1,7,0,0.003770246
982640065,YusubaTweeta,YusubaTweeta,1,1,0,1,7,0,0.003770246
2789991906,Malikaestrella,Malikaestrella,1,1,0,1,7,0,0.003770246
2844878311,Jusuf112,Jusuf112,1,1,0,1,7,0,0.003770246
2385896943,Halishba786,Halishba786,1,3,0,3,7,0.5,0.086096591
1359373908,f_ar38,f_ar38,1,1,0,1,7,0,0.003770246
2701190712,celasepeca,celasepeca,1,1,0,1,7,0,0.003770246
2807424631,agyptische,agyptische,1,1,0,1,7,0,0.003770246
191227536,maartensnijd,maartensnijd,1,1,0,1,7,0,0.003770246
2572347034,shaami0112,shaami0112,1,1,0,1,7,0,0.003770246
2248566461,YemeniWitness,YemeniWitness,1,0,1,1,7,0,0
208299721,justice_tonyt,justice_tonyt,1,1,0,1,7,0,0.003770246
2738710251,MidEastWatcher,MidEastWatcher,1,1,0,1,7,0,0.003770246
468150014,AbouFoelaan,AbouFoelaan,1,1,0,1,7,0,0.003770246
23226156,bahadorz,bahadorz,1,2,0,2,7,0.5,0.052704998
194602862,zafranfadzil,zafranfadzil,1,1,0,1,7,0,0.003770246
2203576182,UsamaUsama27,UsamaUsama27,1,2,0,2,7,0,0.03716184
495445901,HeilmanJoseph,HeilmanJoseph,1,1,0,1,7,0,0.003770246
2593318868,Osman4132,Osman4132,1,1,0,1,7,0,0.003770246
2616944694,raggu07,raggu07,1,3,0,3,7,0.33333334,0.063166699
2758797431,Dandykinz,Dandykinz,1,3,0,3,7,0.5,0.086096591
1548806300,aboo_rabeea,aboo_rabeea,1,1,0,1,7,0,0.003770246
106064035,AhleFars,AhleFars,1,1,0,1,7,0,0.003770246
274852021,shadabalam7,shadabalam7,1,2,0,2,7,0.5,0.052704998
2287167684,serfirazteyrbaz,serfirazteyrbaz,1,1,0,1,7,0,0.003770246
813286,BarackObama,BarackObama,1,0,2,2,7,0.5,0
2679924973,AbuMahdiHind,AbuMahdiHind,1,1,0,1,7,0,0.003770246
2581162298,Bint_Yusuf1,Bint_Yusuf1,1,1,0,1,7,0,0.003770246
2509072744,Turntoreturn,Turntoreturn,1,1,0,1,7,0,0.003770246
311060849,thewayofsalafi,thewayofsalafi,1,2,0,2,7,0.5,0.052704998
1478179904,zamarakara,zamarakara,1,1,0,1,7,0,0.003770246
357362074,asmudeen1,asmudeen1,1,1,0,1,7,0,0.003770246
2535680485,Adnanaijaz_AA7,Adnanaijaz_AA7,1,1,0,1,7,0,0.003770246
224815601,JusIbnAbi,JusIbnAbi,1,2,0,2,7,0,0.03716184
66087448,Qaraday,Qaraday,1,1,0,1,7,0,0.003770246
2686347812,mamjadfrq,mamjadfrq,1,1,0,1,7,0,0.003770246
2702633541,IbnaUmmah,IbnaUmmah,1,1,0,1,7,0,0.003770246
1252321934,MAIDULISLAMBD,MAIDULISLAMBD,1,1,0,1,7,0,0.003770246
2674191024,AlAsr04,AlAsr04,1,3,0,3,7,0.5,0.086096591
2818009843,jsAlBritani,jsAlBritani,1,1,0,1,7,0,0.003770246
2772626242,thierrybachman2,thierrybachman2,1,1,0,1,7,0,0.003770246
2730290029,xalillullah,xalillullah,1,1,0,1,7,0,0.003770246
1693870982,Khally2012H,Khally2012H,1,1,0,1,7,0,0.003770246
156199851,Frozen_eye,Frozen_eye,1,1,0,1,7,0,0.003770246
2414701525,mohamed74989469,mohamed74989469,1,1,0,1,7,0,0.003770246
2855398369,SaudiWitness,SaudiWitness,1,0,1,1,7,0,0
2742021111,AbuYourDad,AbuYourDad,1,1,0,1,7,0,0.003770246
1198812181,CheekyDictator,CheekyDictator,1,2,0,2,7,0.5,0.052704998
2732354611,FaithNvd,FaithNvd,1,1,0,1,7,0,0.003770246
18541636,mattholehouse,mattholehouse,1,2,0,2,7,0.5,0.052704998
1658163728,Miss_Chocolata,Miss_Chocolata,1,1,0,1,7,0,0.003770246
2586078456,JamesWil65,JamesWil65,1,3,0,3,7,0.5,0.077416012
2739301647,samar_dan,samar_dan,1,3,0,3,7,0.33333334,0.063166699
2649767128,RIZASHKHAN,RIZASHKHAN,1,2,0,2,7,0.5,0.052704998
2817748280,saifsword47,saifsword47,1,1,0,1,7,0,0.003770246
29158788,003adam,003adam,1,3,0,3,7,0.5,0.063531114
1860955554,salam_zayn,salam_zayn,1,2,0,2,7,0.5,0.052704998
2427022843,Imarat__kavkaz,Imarat__kavkaz,1,2,0,2,7,0.5,0.052704998
2705452604,NidaNidafizah,NidaNidafizah,1,2,0,2,7,0.5,0.052704998
154136145,UMAR304,UMAR304,1,1,0,1,7,0,0.003770246
111373943,lalibellla,lalibellla,1,1,0,1,7,0,0.003770246
44232361,kareemJerusalem,kareemJerusalem,1,1,0,1,7,0,0.003770246
2239950514,samad12388,samad12388,1,2,0,2,7,0.5,0.052704998
2735206085,FarisBritani,FarisBritani,1,51,1222,1273,7,6.58E-04,0.045700613
2831052542,nuruddin511,nuruddin511,1,1,0,1,7,0,0.003770246
2730290981,umm3hyatt,umm3hyatt,1,1,0,1,7,0,0.003770246
2561273673,Soldierofjihad,Soldierofjihad,1,2,1,3,7,0.5,0.052704998
66842568,Djumroni,Djumroni,1,1,0,1,7,0,0.003770246
2768061557,KopTam,KopTam,1,5,0,5,7,0.35,0.098703829
2826924120,KittensFlowers,KittensFlowers,1,1,0,1,7,0,0.003770246
245428318,BrUnY_No1,BrUnY_No1,1,2,0,2,7,0,0.03716184
347959437,FelicityMorse,FelicityMorse,1,1,0,1,7,0,0.003770246
23032045,aissaaah,aissaaah,1,2,0,2,7,0.5,0.052704998
2458251546,jamesmsa,jamesmsa,1,3,0,3,7,0.33333334,0.087454559
196735267,_Muhajabah_,_Muhajabah_,1,1,0,1,7,0,0.003770246
2799497511,IS_Khurrassan,IS_Khurrassan,1,1,0,1,7,0,0.003770246
2833641801,Ghurabaax,Ghurabaax,1,1,0,1,7,0,0.003770246
2575069544,JaromirEseev,JaromirEseev,1,1,0,1,7,0,0.003770246
2817421742,Ibrahim3Abu,Ibrahim3Abu,1,1,0,1,7,0,0.003770246
2787602925,hidaya_idris,hidaya_idris,1,3,0,3,7,0.5,0.086096591
2356122379,2013Latypov,2013Latypov,1,1,0,1,7,0,0.003770246
177009232,sunmoon_16,sunmoon_16,1,1,0,1,7,0,0.003770246
2334192211,UKHILAFAH,UKHILAFAH,1,4,0,4,7,0.5,0.096558292
2784916184,Sean_Ulama,Sean_Ulama,1,2,0,2,7,0.5,0.052704998
585691887,ArmanOvi2,ArmanOvi2,1,1,0,1,7,0,0.003770246
2664231674,E_MohamedWaheeb,E_MohamedWaheeb,1,1,0,1,7,0,0.003770246
2759586623,islamourr,islamourr,1,1,0,1,7,0,0.003770246
224296419,penyn,penyn,1,1,0,1,7,0,0.003770246
87651219,muslimafilipina,muslimafilipina,1,1,0,1,7,0,0.003770246
2723342492,aminayalchin,aminayalchin,1,1,0,1,7,0,0.003770246
2763748310,n9ar1,n9ar1,1,1,0,1,7,0,0.003770246
175895551,saeedbrother,saeedbrother,1,2,1,3,7,0,0.03716184
2785571896,Ahmad666Liyaqat,Ahmad666Liyaqat,1,1,0,1,7,0,0.003770246
2608690387,karfenburg,karfenburg,1,4,0,4,7,0.5,0.096558292
2741171439,Seiber2014,Seiber2014,1,2,0,2,7,0.5,0.014596362
2609837318,ubed_musa,ubed_musa,1,1,0,1,7,0,0.003770246
2831545614,Yaseen022,Yaseen022,1,3,0,3,7,0.5,0.086096591
359658776,AbduRashid_,AbduRashid_,1,1,0,1,7,0,0.003770246
322598247,melano89,melano89,1,4,0,4,7,0.5,0.096558292
2785277302,SitiAmi34254132,SitiAmi34254132,1,1,0,1,7,0,0.003770246
621770134,Guzmona_indra,Guzmona_indra,1,3,0,3,7,0.33333334,0.063166699
2775512476,salumallysalum2,salumallysalum2,1,1,0,1,7,0,0.003770246
216659406,steveswannBBC,steveswannBBC,1,2,0,2,7,0,0.03716184
784365073,Ayetgin66,Ayetgin66,1,1,0,1,7,0,0.003770246
2174088780,piztyolo,piztyolo,1,1,0,1,7,0,0.003770246
2171108962,Pierrotbass,Pierrotbass,1,1,0,1,7,0,0.003770246
84702826,DESHIHUJUR,DESHIHUJUR,1,3,0,3,7,0.5,0.086096591
2588538518,Abu_Mihjan,Abu_Mihjan,1,1,0,1,7,0,0.003770246
2773350123,AliYare145,AliYare145,1,2,0,2,7,0.5,0.052704998
1690662674,WarrenClark64,WarrenClark64,1,2,0,2,7,0.5,0.052704998
2570155899,endoftimesdream,endoftimesdream,1,1,0,1,7,0,0.003770246
203028404,Mr_Sam_Stewart,Mr_Sam_Stewart,1,1,0,1,7,0,0.003770246
2797139976,Sikuda_Lumpia,Sikuda_Lumpia,1,1,0,1,7,0,0.003770246
2308199430,amiralghazi76,amiralghazi76,1,5,0,5,7,0.5,0.121269307
2418899006,turabi3544,turabi3544,1,1,0,1,7,0,0.003770246
2746677426,Guate_American,Guate_American,1,1,0,1,7,0,0.003770246
636942560,pisec_resnice,pisec_resnice,1,1,0,1,7,0,0.003770246
2705324268,mrchow120,mrchow120,1,5,0,5,7,0.5,0.121269307
2759817462,DawlahQamat1,DawlahQamat1,1,1,0,1,7,0,0.003770246
22378816,aikey,aikey,1,1,0,1,7,0,0.003770246
564689291,saifalkanadi,saifalkanadi,1,1,0,1,7,0,0.003770246
2744646029,ChiversJade,ChiversJade,1,1,0,1,7,0,0.003770246
25098783,MonicaRaeX,MonicaRaeX,1,1,0,1,7,0,0.003770246
2722265670,faezehahmd,faezehahmd,1,3,0,3,7,0.5,0.086096591
1976564377,Muslimah2Mumina,Muslimah2Mumina,1,1,0,1,7,0,0.003770246
2821192395,MabdiAbdi,MabdiAbdi,1,2,0,2,7,0,0.028481261
1649736422,zaidhasman,zaidhasman,1,1,0,1,7,0,0.003770246
237796149,Ienayat_Javaid,Ienayat_Javaid,1,4,0,4,7,0.41666666,0.088242128
2829122381,guja444,guja444,1,3,0,3,7,0.33333334,0.063166699
2796157888,voip111,voip111,1,1,0,1,7,0,0.003770246
2635463654,jays22380_jay,jays22380_jay,1,1,0,1,7,0,0.003770246
2764831804,TakfirTaghut,TakfirTaghut,1,1,0,1,7,0,0.003770246
1538686172,Salashh,Salashh,1,2,0,2,7,0.5,0.052704998
89226485,Will_Watkinson,Will_Watkinson,1,1,0,1,7,0,0.003770246
700087662,eneyaxe,eneyaxe,1,3,0,3,7,0.5,0.086096591
2667380119,AsimEbuMerjem,AsimEbuMerjem,1,2,0,2,7,0,0.028481261
1316190906,Muzamil0047Khan,Muzamil0047Khan,1,4,0,4,7,0.5,0.096558292
2435131982,El_Eskandarany,El_Eskandarany,1,1,0,1,7,0,0.003770246
506166768,nur_hussein,nur_hussein,1,2,0,2,7,0.5,0.052704998
16973333,Independent,Independent,1,0,1,1,7,0,0
532020773,zeexXxzee,zeexXxzee,1,1,0,1,7,0,0.003770246
2209742392,rabiasquared,rabiasquared,1,1,0,1,7,0,0.003770246
396459589,miqdad14,miqdad14,1,1,0,1,7,0,0.003770246
202309203,hrusaf,hrusaf,1,1,0,1,7,0,0.003770246
2175860341,Dhikrullaha,Dhikrullaha,1,2,0,2,7,0,0.014231947
1489075844,AbuTawfique,AbuTawfique,1,3,0,3,7,0.33333334,0.063166699
47283859,privacylover,privacylover,1,1,0,1,7,0,0.003770246
2798780069,CentralGhent,CentralGhent,1,1,0,1,7,0,0.003770246
2515795693,OmaralbaghdadiO,OmaralbaghdadiO,1,2,0,2,7,0.5,0.052704998
2614558556,AbuBakr_AlQudsi,AbuBakr_AlQudsi,1,1,0,1,7,0,0.003770246
2749693813,JihadonJihad,JihadonJihad,1,1,0,1,7,0,0.003770246
146931599,ChiweNacho,ChiweNacho,1,1,0,1,7,0,0.003770246
2588311472,hghkwhvn2,hghkwhvn2,1,1,0,1,7,0,0.003770246
2828795919,MinhajiNoubouwa,MinhajiNoubouwa,1,2,0,2,3,1,0.073645766
762544164,ijazik,ijazik,1,1,0,1,3,0,0.024711015
1575977101,Ukht_A,Ukht_A,1,1,0,1,3,0,0.024711015
1694990480,Thoar_Syria,Thoar_Syria,1,0,1,1,3,0,0
2464841881,DasguteWort,DasguteWort,1,1,0,1,3,0,0.024711015
332791991,blakehunsicker,blakehunsicker,1,1,0,1,3,0,0.024711015
51249414,Calla415,Calla415,1,0,1,1,3,0,0
1595506969,darwensound,darwensound,1,1,0,1,3,0,0.024711015
770179418,ABomsamalaser,ABomsamalaser,1,0,1,1,3,0,0
1767178633,sdudah1,sdudah1,1,5,0,5,3,0.5,0.121269307
157483427,adamfhutton,adamfhutton,1,0,1,1,3,0,0
297796024,a7taker,a7taker,1,0,1,1,3,0,0
2829156815,isworldpress13,isworldpress13,1,0,1,1,3,0,0
603455960,Qs__3,Qs__3,1,1,0,1,3,0,0.024711015
113410551,gokesher,gokesher,1,0,1,1,3,0,0
2524021280,SaleemKundi,SaleemKundi,1,1,0,1,3,0,0.024711015
2755920456,tnt_tnt_7,tnt_tnt_7,1,0,1,1,3,0,0
2818015861,hihowareyou2020,hihowareyou2020,1,1,0,1,3,0,0.024711015
2795897545,mby1abuammar,mby1abuammar,1,2,0,2,3,1,0.073645766
2763752138,DomingoSoraya,DomingoSoraya,1,1,0,1,3,0,0.024711015
392332071,EvanStavisky,EvanStavisky,1,0,1,1,3,0,0
2853602178,KeepyourF,KeepyourF,1,3,0,3,3,0.8333333,0.10703736
1269498764,kazil313,kazil313,1,2,0,2,3,0.5,0.035172715
718046173,ja3fr_,ja3fr_,1,0,1,1,3,0,0
490505193,albaghdadi313,albaghdadi313,1,3,0,3,3,0.16666667,0.061872854
582255615,KevinBryce1,KevinBryce1,1,1,0,1,3,0,0.024711015
2841674760,man_goog,man_goog,1,1,0,1,3,0,0.024711015
2649687060,IndianWitness,IndianWitness,1,3,1,4,3,0.5,0.077416012
1352729624,a_azraeel,a_azraeel,1,0,1,1,3,0,0
2701067399,AdamJulaybieb,AdamJulaybieb,1,2,0,2,3,0.5,0.058102608
25363594,gregoryrose,gregoryrose,1,0,1,1,3,0,0
2786487149,GundemTevhidi,GundemTevhidi,1,1,0,1,3,0,0.024711015
2854487264,fallsis1,fallsis1,1,3,0,3,3,0.5,0.077416012
1120011516,CJohnson_gta,CJohnson_gta,1,2,0,2,3,0.5,0.035172715
1140819217,Eye_onsomalia,Eye_onsomalia,1,0,1,1,3,0,0
542016794,MilestoneIslam,MilestoneIslam,1,1,0,1,3,0,0.024711015
1653351390,Mchd21,Mchd21,1,1,0,1,3,0,0.024711015
2703328574,ErBreeze,ErBreeze,1,1,0,1,3,0,0.024711015
2337965419,JnDar3a,JnDar3a,1,0,1,1,3,0,0
592938432,abo3bdalrhmn,abo3bdalrhmn,1,0,1,1,3,0,0
2827421164,abuzarqawi88,abuzarqawi88,1,1,0,1,3,0,0.024711015
2811168318,jacklin90856,jacklin90856,1,1,0,1,3,0,0.024711015
1100842615,IslamicFront_R,IslamicFront_R,1,0,1,1,3,0,0
234260088,eshaddd,eshaddd,1,1,0,1,3,0,0.024711015
912066212,hmzh232,hmzh232,1,1,0,1,3,0,0.024711015
2713093828,5084cf4e8ae045d,5084cf4e8ae045d,1,1,0,1,3,0,0.024711015
596215496,AsadAljehad2,AsadAljehad2,1,0,1,1,3,0,0
2852947693,BangsamoroJihad,BangsamoroJihad,1,2,0,2,3,1,0.073645766
534939392,bakeel44,bakeel44,1,0,1,1,3,0,0
1113556759,TalalBazerbashe,TalalBazerbashe,1,0,1,1,3,0,0
711133039,AimarMalecSubei,AimarMalecSubei,1,1,0,1,3,0,0.024711015
2775156667,Alshame123Katab,Alshame123Katab,1,0,1,1,3,0,0
263456734,dochijazi,dochijazi,1,0,2,2,3,0.5,0
2774861884,mur4tava,mur4tava,1,1,0,1,3,0,0.024711015
1713506418,islamicfajer,islamicfajer,1,0,1,1,3,0,0
2404059261,aramasad222,aramasad222,1,1,0,1,3,0,0.024711015
2431453367,atariqniaz,atariqniaz,1,5,0,5,3,0.5,0.121269307
2213677285,khaledalmojahe1,khaledalmojahe1,1,0,1,1,3,0,0
2737375481,sefknylmaz,sefknylmaz,1,2,0,2,3,0.5,0.058102608
2249394426,sameerkakeh,sameerkakeh,1,0,1,1,3,0,0
2836597025,Siham_1435,Siham_1435,1,3,0,3,3,0.8333333,0.10703736
18843972,raydowd,raydowd,1,0,1,1,3,0,0
2861369678,tetuan1992,tetuan1992,1,1,0,1,3,0,0.024711015
2806024600,akhi47reloaded,akhi47reloaded,1,1,0,1,3,0,0.024711015
1638861247,K_ALkhadraa,K_ALkhadraa,1,0,1,1,3,0,0
2854226390,Naazir_,Naazir_,1,1,0,1,3,0,0.024711015
2435582442,FlaLfna,FlaLfna,1,2,0,2,3,1,0.073645766
124488204,harunahamisi,harunahamisi,1,2,0,2,3,1,0.073645766
2442168886,abu55waleed,abu55waleed,1,1,0,1,3,0,0.024711015
1555794620,dedi_77071,dedi_77071,1,2,0,2,3,0.5,0.075003734
248089280,Rebelishfaq,Rebelishfaq,1,1,0,1,3,0,0.024711015
2799307639,Ummyusuf7,Ummyusuf7,1,2,0,2,3,1,0.073645766
910978201,abuabbas5,abuabbas5,1,0,1,1,3,0,0
2527071181,Abu_Ibrahim1413,Abu_Ibrahim1413,1,4,0,4,3,0.16666667,0.049769078
2348714970,AbuDjuhayman,AbuDjuhayman,1,2,0,2,3,0.5,0.058102608
2820213742,abowaleed651,abowaleed651,1,1,0,1,3,0,0.024711015
1004735472,ibrdidi,ibrdidi,1,1,0,1,3,0,0.024711015
1015033008,umayrk90,umayrk90,1,1,0,1,3,0,0.024711015
2719255605,SkHaziii,SkHaziii,1,1,0,1,3,0,0.024711015
257002633,ausfatima,ausfatima,1,1,0,1,3,0,0.024711015
2517893656,abdijum,abdijum,1,1,0,1,3,0,0.024711015
2603191448,Omar2top,Omar2top,1,3,0,3,3,0.8333333,0.123938486
68127916,ksmsj,ksmsj,1,1,0,1,3,0,0.024711015
1239780558,fight4haqq,fight4haqq,1,4,0,4,3,0.8333333,0.157330079
2836696321,alshami1000000,alshami1000000,1,0,2,2,3,0.5,0
2724957560,shvmshvm86,shvmshvm86,1,0,3,3,3,0.6666667,0
2772602234,Salaahudiin1,Salaahudiin1,1,3,0,3,3,0.8333333,0.10703736
2602740970,igogre,igogre,1,1,0,1,3,0,0.024711015
1389628818,based_tweet,based_tweet,1,2,0,2,3,0.5,0.035172715
2819591603,aliumarabubakr1,aliumarabubakr1,1,2,0,2,3,1,0.073645766
169086423,zakyfuadz,zakyfuadz,1,1,0,1,3,0,0.024711015
21761523,fernandoa,fernandoa,1,0,1,1,3,0,0
1438912026,bader_alsham,bader_alsham,1,0,1,1,3,0,0
74944078,Blazin2k10,Blazin2k10,1,2,0,2,3,0.5,0.058102608
2847018578,mqkk1977,mqkk1977,1,1,0,1,3,0,0.024711015
2821688680,BritnerAlex,BritnerAlex,1,1,0,1,3,0,0.024711015
2672594625,ishakaomoh50,ishakaomoh50,1,3,0,3,3,0.8333333,0.10703736
1139871452,kh4_kh5,kh4_kh5,1,0,1,1,3,0,0
129011450,emmaa_rushha,emmaa_rushha,1,1,0,1,3,0,0.024711015
1386778428,Nur7M,Nur7M,1,1,0,1,3,0,0.024711015
2431029070,safi_rs,safi_rs,1,1,0,1,3,0,0.024711015
47615880,ReemMakhoul,ReemMakhoul,1,3,1,4,3,0.8333333,0.10703736
107810743,Yigo2,Yigo2,1,1,0,1,3,0,0.024711015
2395279361,Jkl_33,Jkl_33,1,0,1,1,3,0,0
228855824,IBRAHIMRASHAD,IBRAHIMRASHAD,1,2,0,2,3,0.5,0.058102608
2399572011,RahmeTemhar,RahmeTemhar,1,1,0,1,3,0,0.024711015
2802389053,IbnuNasr,IbnuNasr,1,2,0,2,3,1,0.073645766
850530368,leegallig,leegallig,1,1,0,1,3,0,0.024711015
2781155438,UngalKhan,UngalKhan,1,1,0,1,3,0,0.024711015
1040781450,Abuhuraira321,Abuhuraira321,1,1,0,1,3,0,0.024711015
2809598218,Truth_unveiled1,Truth_unveiled1,1,1,0,1,3,0,0.024711015
2203029818,ubm89,ubm89,1,2,0,2,3,1,0.073645766
968331817,Zuzu12338,Zuzu12338,1,1,0,1,3,0,0.024711015
2374242882,albattaralshami,albattaralshami,1,1,0,1,3,0,0.024711015
2775454323,faluja456,faluja456,1,0,1,1,3,0,0
975049340,sul_abd,sul_abd,1,3,0,3,3,0.8333333,0.10703736
2787414665,WaziriWitness,WaziriWitness,1,1,0,1,3,0,0.024711015
912069336,BestMudasir8,BestMudasir8,1,1,0,1,3,0,0.024711015
2286588643,abotalhaa,abotalhaa,1,0,1,1,3,0,0
2177307440,Abuzainedin,Abuzainedin,1,1,0,1,3,0,0.024711015
2855834426,MaliziyMuj,MaliziyMuj,1,3,0,3,3,0.8333333,0.10703736
2740672658,firat4737,firat4737,1,2,0,2,3,0.5,0.075003734
2547651463,Dabiiq,Dabiiq,1,1,0,1,3,0,0.024711015
29734444,DanGarodnick,DanGarodnick,1,0,1,1,3,0,0
707466229,HMunib,HMunib,1,1,0,1,3,0,0.024711015
2861437958,al_sufi_,al_sufi_,1,1,0,1,3,0,0.024711015
813536269,ab_osama1,ab_osama1,1,0,1,1,3,0,0
2867336250,MajeedMsd99,MajeedMsd99,1,1,0,1,3,0,0.024711015
374462657,DRHamed_H_Alali,DRHamed_H_Alali,1,0,1,1,3,0,0
999822500,Abd_ul_Matin,Abd_ul_Matin,1,3,0,3,3,0.16666667,0.038942962
999527605,AnisseAlmansour,AnisseAlmansour,1,2,0,2,3,0.5,0.058102608
2729120969,chomanrudaw,chomanrudaw,1,1,0,1,3,0,0.024711015
559912144,wibowoHary13,wibowoHary13,1,1,0,1,3,0,0.024711015
2735772893,UmFidah,UmFidah,1,1,0,1,3,0,0.024711015
554374390,TheTweetingZed,TheTweetingZed,1,1,0,1,3,0,0.024711015
2544047400,ibnudawla,ibnudawla,1,3,0,3,3,0.8333333,0.10703736
21879007,finifenmaa,finifenmaa,1,1,0,1,3,0,0.024711015
2572397158,limpid68,limpid68,1,2,0,2,3,1,0.073645766
19076503,lcholdenbrown,lcholdenbrown,1,0,1,1,3,0,0
2424378806,palm_tree99,palm_tree99,1,1,0,1,3,0,0.024711015
2809894409,abo987khaled,abo987khaled,1,0,1,1,3,0,0
195270215,ahmadrahimi1,ahmadrahimi1,1,1,0,1,3,0,0.024711015
128587419,emisshula,emisshula,1,0,1,1,3,0,0
2220725954,jonodx73,jonodx73,1,0,1,1,3,0,0
2824902393,GoForthNow,GoForthNow,1,2,0,2,3,1,0.073645766
2783745836,AbuHaitham13,AbuHaitham13,1,2,0,2,3,0,0.028481261
2605225802,Tariqbz85,Tariqbz85,1,2,0,2,3,0,0.028481261
569579355,HayatJihad,HayatJihad,1,2,0,2,3,1,0.073645766
2795640810,GLA____,GLA____,1,5,0,5,3,0.35,0.098703829
2567444544,musaab9991,musaab9991,1,2,0,2,3,0.5,0.035172715
79992898,alhosamy,alhosamy,1,1,0,1,3,0,0.024711015
2749601897,Anvarsami,Anvarsami,1,5,0,5,3,0.5,0.121269307
2530646192,8766Rashad,8766Rashad,1,1,0,1,3,0,0.024711015
409245984,DetlefKnieschlg,DetlefKnieschlg,1,1,0,1,3,0,0.024711015
2539559261,muhajirghareeb,muhajirghareeb,1,4,0,4,3,0.75,0.117499061
2672957817,adam_J14,adam_J14,1,1,0,1,3,0,0.024711015
2203883910,a_zeydan,a_zeydan,1,0,1,1,3,0,0
15762497,jujukoo,jujukoo,1,0,1,1,3,0,0
2527631755,hazzm_movment,hazzm_movment,1,0,2,2,3,1,0
2610108829,FarisAlatlas1,FarisAlatlas1,1,1,0,1,3,0,0.024711015
2775947796,muhajir770,muhajir770,1,0,1,1,3,0,0
2846235168,Deliro77J,Deliro77J,1,1,0,1,3,0,0.024711015
2812819278,shame_J,shame_J,1,0,1,1,3,0,0
2746784464,aaeshadl,aaeshadl,1,1,0,1,3,0,0.024711015
1322556121,sa3dismaiel,sa3dismaiel,1,1,0,1,3,0,0.024711015
1546197474,eyligaa121,eyligaa121,1,1,0,1,3,0,0.024711015
2360089493,8Alwrdan,8Alwrdan,1,1,0,1,3,0,0.024711015
1115298728,yuba90,yuba90,1,2,0,2,3,0.5,0.058102608
2776407066,alommah_army,alommah_army,1,0,1,1,3,0,0
2849315936,soph7133,soph7133,1,4,0,4,3,0.41666666,0.088242128
825334915,EarthsStranger,EarthsStranger,1,6,1,7,3,0.4,0.132095423
226565273,analyst8,analyst8,1,3,0,3,3,0.6666667,0.068564309
1124932832,lexyakram,lexyakram,1,2,0,2,3,0,0.028481261
2590940402,mamoonhatem7,mamoonhatem7,1,0,1,1,3,0,0
927177974,Sh84Omar,Sh84Omar,1,0,1,1,3,0,0
2672827710,bougi2014,bougi2014,1,1,0,1,3,0,0.024711015
293477703,arshad_dublin,arshad_dublin,1,1,0,1,3,0,0.024711015
2800000337,Gazwa_E_Hind,Gazwa_E_Hind,1,1,0,1,3,0,0.024711015
235183519,waleedAMB,waleedAMB,1,1,0,1,3,0,0.024711015
104308171,dawahmedia,dawahmedia,1,3,0,3,3,0.8333333,0.10703736
548740569,3amaral7arery,3amaral7arery,1,0,1,1,3,0,0
30580256,REALLYnotME1,REALLYnotME1,1,3,0,3,3,0.16666667,0.061872854
1360446726,sofienbenhassen,sofienbenhassen,1,1,0,1,3,0,0.024711015
2592874050,rasheedhere,rasheedhere,1,1,0,1,3,0,0.024711015
2826378825,U0WhHF3BOQaXksN,U0WhHF3BOQaXksN,1,1,0,1,3,0,0.024711015
2412944989,FatherLight1,FatherLight1,1,1,0,1,3,0,0.024711015
536485550,aljamal2007,aljamal2007,1,0,1,1,3,0,0
2609159942,Abualfida3,Abualfida3,1,3,0,3,3,0.8333333,0.10703736
230792971,Abdiif,Abdiif,1,2,0,2,3,0,0.028481261
2547130134,AlphaPugg,AlphaPugg,1,1,0,1,3,0,0.024711015
304061072,MaxoFaliani,MaxoFaliani,1,1,0,1,3,0,0.024711015
136421267,aksua20,aksua20,1,1,0,1,3,0,0.024711015
2188877718,muslemmoahed,muslemmoahed,1,0,1,1,3,0,0
34918615,GottaRunWithWil,GottaRunWithWil,1,0,1,1,3,0,0
2816450518,lolo1234533,lolo1234533,1,1,0,1,3,0,0.024711015
311697394,MineSbai,MineSbai,1,2,0,2,3,0,0.035537131
2672074739,AbuHso,AbuHso,1,2,0,2,3,1,0.073645766
1671798884,al_shafak,al_shafak,1,1,0,1,3,0,0.024711015
2746065025,zxcvbnm47067720,zxcvbnm47067720,1,2,0,2,3,0.5,0.035172715
153788589,moradalz,moradalz,1,5,0,5,3,0.5,0.121269307
2777358661,Sunnah02,Sunnah02,1,2,0,2,3,1,0.073645766
2239537723,apomalik82,apomalik82,1,0,1,1,3,0,0
59810425,hadiabu_uba,hadiabu_uba,1,1,0,1,3,0,0.024711015
2786239128,ansarulsunnah,ansarulsunnah,1,2,0,2,3,1,0.073645766
703374018,bintaltawhid,bintaltawhid,1,1,0,1,3,0,0.024711015
1145348822,ab0azez,ab0azez,1,0,1,1,3,0,0
2788106975,anonakh,anonakh,1,2,0,2,3,0.5,0.058102608
1031873256,thecominglife,thecominglife,1,1,0,1,3,0,0.024711015
151921529,agounardes,agounardes,1,0,1,1,3,0,0
1894982538,kooks_1,kooks_1,1,3,0,3,3,0.6666667,0.068564309
2319328176,TurkMucahit,TurkMucahit,1,3,0,3,3,0.6666667,0.084107467
891233203,khaled852111,khaled852111,1,0,1,1,3,0,0
2529403834,NourideenZinki,NourideenZinki,1,1,0,1,3,0,0.024711015
2815632528,BubaJankeh1,BubaJankeh1,1,2,0,2,3,0.5,0.058102608
149169332,tepatihk,tepatihk,1,3,0,3,3,0.6666667,0.084107467
57574944,fluturo,fluturo,1,1,0,1,3,0,0.024711015
2274600229,ReservedK,ReservedK,1,4,2,6,3,0.75,0.117499061
2815108486,malanadaI5I5,malanadaI5I5,1,2,0,2,3,1,0.073645766
160540039,irhamh7,irhamh7,1,4,0,4,3,0.75,0.117499061
14427603,ArabCrunch,ArabCrunch,1,3,0,3,3,0.5,0.077416012
2811078130,isnaf10,isnaf10,1,2,0,2,3,0.5,0.058102608
2248484372,usame_aslan,usame_aslan,1,1,0,1,3,0,0.024711015
2446140973,AbuHafsDz,AbuHafsDz,1,4,1,5,3,0.41666666,0.088242128
370452030,ozi_uddin,ozi_uddin,1,2,0,2,3,0.5,0.035172715
1647191652,BadriaArvi,BadriaArvi,1,1,0,1,3,0,0.024711015
220800741,ebuamina76,ebuamina76,1,5,0,5,3,0.35,0.098703829
2763368229,nahnuqadimun,nahnuqadimun,1,2,0,2,3,0.5,0.058102608
2691887416,abenzin3,abenzin3,1,1,0,1,3,0,0.024711015
816850801,SaqibRaja6,SaqibRaja6,1,4,0,4,3,0.5,0.110807606
1725908628,jauadshami,jauadshami,1,0,1,1,3,0,0
269002625,abuusama1,abuusama1,1,1,0,1,3,0,0.024711015
270444418,MsHoYoung,MsHoYoung,1,0,1,1,3,0,0
2456594335,AbdulhaqO,AbdulhaqO,1,1,0,1,3,0,0.024711015
462309024,BengalShazada,BengalShazada,1,1,0,1,3,0,0.024711015
1898915798,alrayaalwaheda,alrayaalwaheda,1,0,1,1,3,0,0
1471672674,yusf_shgge,yusf_shgge,1,1,0,1,3,0,0.024711015
2836867200,muraasil_,muraasil_,1,3,0,3,3,0.8333333,0.10703736
2595989672,IbnouKais,IbnouKais,1,2,0,2,3,1,0.073645766
2295591286,SuperDrySuper,SuperDrySuper,1,3,0,3,3,0.6666667,0.068564309
46442765,metesohtaoglu,metesohtaoglu,1,1,0,1,3,0,0.024711015
2697832724,darulqadaa,darulqadaa,1,0,1,1,3,0,0
776644921,areeeee1,areeeee1,1,3,0,3,3,0.16666667,0.061872854
2319558985,mhalshame,mhalshame,1,0,1,1,3,0,0
61780365,siteintelgroup,siteintelgroup,1,0,1,1,3,0,0
1397762450,rubbi_Allah,rubbi_Allah,1,3,0,3,3,0.6666667,0.084107467
2806917543,awaiskhan66629,awaiskhan66629,1,1,0,1,3,0,0.024711015
110340586,WordsOfHakim,WordsOfHakim,1,0,1,1,3,0,0
2786270326,abuanashasani,abuanashasani,1,0,1,1,3,0,0
2620566238,ASallahdin,ASallahdin,1,1,0,1,3,0,0.024711015
574204675,cojaf,cojaf,1,1,0,1,3,0,0.024711015
2794433285,abdussametplt,abdussametplt,1,1,0,1,3,0,0.024711015
2180360982,AmeerUlBahr,AmeerUlBahr,1,2,1,3,3,1,0.073645766
2625350438,truthseekersz,truthseekersz,1,1,0,1,3,0,0.024711015
2847681325,aramxambae24,aramxambae24,1,1,0,1,3,0,0.024711015
2501674820,ayshaali1981,ayshaali1981,1,4,0,4,3,0.75,0.117499061
255470513,Allyn3237,Allyn3237,1,3,0,3,3,0.16666667,0.061872854
2602118125,KhanSaeedyzi,KhanSaeedyzi,1,1,0,1,3,0,0.024711015
2801354580,Abdul_Malik_1,Abdul_Malik_1,1,1,0,1,3,0,0.024711015
2611621010,alghareeb110,alghareeb110,1,2,0,2,3,0.5,0.035172715
48049304,mrdonderpreek,mrdonderpreek,1,3,0,3,3,0.6666667,0.068564309
2788306091,BaniHillal,BaniHillal,1,2,1,3,3,0.5,0.052704998
2822614204,HabibHubbiy,HabibHubbiy,1,3,0,3,3,0.16666667,0.068928724
1878427512,ibnirumi,ibnirumi,1,1,0,1,3,0,0.024711015
2613652760,AskerKrim,AskerKrim,1,1,0,1,3,0,0.024711015
713698682,muhager66,muhager66,1,0,1,1,3,0,0
312487372,naim_nta,naim_nta,1,1,0,1,3,0,0.024711015
2538221006,Muwehid1203,Muwehid1203,1,1,0,1,3,0,0.024711015
107458020,zoboxrox,zoboxrox,1,0,1,1,3,0,0
2325327336,Azizulsaimin,Azizulsaimin,1,1,0,1,3,0,0.024711015
2269064718,IF_Focus,IF_Focus,1,1,2,3,3,0.6666667,0.010461701
2150149701,Abu_Taaha,Abu_Taaha,1,1,0,1,3,0,0.024711015
46376581,ashrafghani,ashrafghani,1,0,1,1,3,0,0
2806722163,AbuJaberSh,AbuJaberSh,1,0,1,1,3,0,0
2776543862,SaeedJaedy,SaeedJaedy,1,2,0,2,3,0.5,0.058102608
2816716553,lavangee_mo,lavangee_mo,1,2,0,2,3,1,0.073645766
2835820303,modee78600,modee78600,1,1,0,1,3,0,0.024711015
1542893335,HezabrJehad,HezabrJehad,1,0,1,1,3,0,0
2664705819,2121Ravda,2121Ravda,1,2,0,2,3,0.5,0.058102608
2849877794,KhaledAlWaleed0,KhaledAlWaleed0,1,2,0,2,3,1,0.073645766
841002864,MoNandOnly,MoNandOnly,1,1,0,1,3,0,0.024711015
707669980,Abu1ubayda,Abu1ubayda,1,0,1,1,3,0,0
2351149049,KaisMosli,KaisMosli,1,2,0,2,3,1,0.073645766
880291837,iQRO4,iQRO4,1,1,0,1,3,0,0.024711015
1877903365,masmas2061,masmas2061,1,1,0,1,3,0,0.024711015
7385152,leguape,leguape,1,1,0,1,3,0,0.024711015
1374859362,ih8un,ih8un,1,1,0,1,3,0,0.024711015
2244128918,gmal_marouf,gmal_marouf,1,0,1,1,3,0,0
1457533086,HamzaJANfighter,HamzaJANfighter,1,1,1,2,3,0.5,0.010461701
344666377,bhatwajid,bhatwajid,1,1,0,1,3,0,0.024711015
562186639,Highlander_Khan,Highlander_Khan,1,1,0,1,3,0,0.024711015
1636441476,al_seasi,al_seasi,1,0,1,1,3,0,0
465940766,CharlesBStone,CharlesBStone,1,0,1,1,3,0,0
2602348912,dilzarka,dilzarka,1,1,0,1,3,0,0.024711015
45494700,aushev,aushev,1,3,0,3,3,0.33333334,0.069011456
174065750,dekabryan,dekabryan,1,1,0,1,3,0,0.024711015
629060109,Lottofreak,Lottofreak,1,1,0,1,3,0,0.024711015
2367631892,anlamazdinki,anlamazdinki,1,2,0,2,3,0.5,0.058102608
55085147,MicahKellner,MicahKellner,1,0,1,1,3,0,0
54178341,BenSai,BenSai,1,1,0,1,3,0,0.024711015
794047015,hmmm_nnnnn,hmmm_nnnnn,1,1,0,1,3,0,0.024711015
1949053488,GaziToken,GaziToken,1,1,0,1,3,0,0.024711015
2776445508,mikerunwild,mikerunwild,1,1,0,1,3,0,0.024711015
244134525,Hamed_Alali,Hamed_Alali,1,0,1,1,3,0,0
1442329266,BrianLeiter,BrianLeiter,1,0,1,1,3,0,0
215233262,3niin1,3niin1,1,1,0,1,3,0,0.024711015
1715909364,akh_hama,akh_hama,1,0,1,1,3,0,0
2763879209,amas1435h,amas1435h,1,0,1,1,3,0,0
2793911092,abohahm11,abohahm11,1,1,0,1,3,0,0.024711015
1073730258,Strategyaffairs,Strategyaffairs,1,0,1,1,3,0,0
2603922368,katoo005,katoo005,1,2,0,2,3,1,0.073645766
2509485017,Albsira_jn,Albsira_jn,1,0,1,1,3,0,0
2206381094,UMMAH710,UMMAH710,1,1,0,1,3,0,0.024711015
2867224075,AbdurRahmanHaqq,AbdurRahmanHaqq,1,1,0,1,3,0,0.024711015
1400222820,Mo3tasimbeallah,Mo3tasimbeallah,1,0,1,1,3,0,0
1693725823,Khurasaniy,Khurasaniy,1,4,0,4,3,0.41666666,0.087877713
1437250765,edgarisgrumpy,edgarisgrumpy,1,1,0,1,3,0,0.024711015
1581391632,foor_ss,foor_ss,1,0,1,1,3,0,0
344601896,om_jali,om_jali,1,1,0,1,3,0,0.024711015
451042867,HassanAbboud_Ah,HassanAbboud_Ah,1,0,2,2,3,1,0
300397904,shaftmedhi,shaftmedhi,1,2,0,2,3,0.5,0.035172715
289480265,vjeshta_,vjeshta_,1,1,0,1,3,0,0.024711015
2818848207,AaymanJ,AaymanJ,1,1,0,1,3,0,0.024711015
2748472006,PraySalat,PraySalat,1,2,0,2,3,1,0.073645766
538064406,AhmedFaarih,AhmedFaarih,1,1,0,1,3,0,0.024711015
455357995,Muhajer2013,Muhajer2013,1,0,1,1,3,0,0
2867410484,Gulstranger,Gulstranger,1,1,0,1,3,0,0.024711015
501784158,raazbuneri,raazbuneri,1,1,0,1,3,0,0.024711015
2452010636,AbuMansoorDk,AbuMansoorDk,1,2,0,2,3,1,0.073645766
1311389364,alhakemalhabeb8,alhakemalhabeb8,1,0,1,1,3,0,0
2763983137,larrybi66099208,larrybi66099208,1,5,0,5,3,0.8,0.16779178
44939027,Colonel_Jafar,Colonel_Jafar,1,2,0,2,3,0.5,0.058102608
2343810888,ALTAF_AHMAD3,ALTAF_AHMAD3,1,1,0,1,3,0,0.024711015
1029960680,jundualsham,jundualsham,1,0,1,1,3,0,0
2751274644,mdabbas0008,mdabbas0008,1,1,0,1,3,0,0.024711015
2459129419,AbduaAbdurafi,AbduaAbdurafi,1,1,0,1,3,0,0.024711015
321582062,AtifBaig21,AtifBaig21,1,1,0,1,3,0,0.024711015
2583797402,fguiwan,fguiwan,1,1,0,1,3,0,0.024711015
1530935293,UtomoAchilles,UtomoAchilles,1,5,0,5,3,0.5,0.121269307
2298624002,ImranSadeeq,ImranSadeeq,1,2,0,2,3,0.5,0.058102608
51987086,5hirlyValentine,5hirlyValentine,1,1,0,1,3,0,0.024711015
518207513,Alshaam_news,Alshaam_news,1,0,1,1,3,0,0
2480126078,313jund,313jund,1,0,4,4,3,0.8333333,0
2793715911,kaibar_99,kaibar_99,1,0,1,1,3,0,0
2280405210,MichaelHaren,MichaelHaren,1,1,0,1,3,0,0.024711015
2851748119,niassuh11,niassuh11,1,1,0,1,3,0,0.024711015
1605777697,samer943,samer943,1,1,0,1,3,0,0.024711015
2441820507,bahrainfalcon71,bahrainfalcon71,1,1,0,1,3,0,0.024711015
2865346910,mutasimbillaah,mutasimbillaah,1,2,0,2,3,1,0.073645766
455653727,AhmetAlKurdi,AhmetAlKurdi,1,1,0,1,3,0,0.024711015
2797779311,Dawlat_Islam2,Dawlat_Islam2,1,341,990,1331,3,8.60E-04,0.380146489
1022278022,punisher2030,punisher2030,1,1,0,1,3,0,0.024711015
2389592472,AasimMohammadIs,AasimMohammadIs,1,1,0,1,3,0,0.024711015
2588817818,AbuUthmane,AbuUthmane,1,2,0,2,3,1,0.073645766
2797287971,baqiyaaa,baqiyaaa,1,1,0,1,3,0,0.024711015
189053479,fvermaenen,fvermaenen,1,3,0,3,3,0.8333333,0.10703736
906771091,HadiAlabdallah,HadiAlabdallah,1,0,1,1,3,0,0
2824551070,abu_light,abu_light,1,1,0,1,3,0,0.024711015
2820586143,Nasirah_NL,Nasirah_NL,1,1,0,1,3,0,0.024711015
323140273,Merozil,Merozil,1,1,0,1,3,0,0.024711015
2686056133,AbdaouiKarim,AbdaouiKarim,1,1,0,1,3,0,0.024711015
2578642046,Arramly_mo7eb,Arramly_mo7eb,1,0,1,1,3,0,0
731003646,Warior1924,Warior1924,1,2,0,2,3,1,0.073645766
335808982,spiralzetsu,spiralzetsu,1,1,0,1,3,0,0.024711015
1553447690,PalpableDisgust,PalpableDisgust,1,1,0,1,3,0,0.024711015
2861054984,1ibraham,1ibraham,1,1,0,1,3,0,0.024711015
2275949592,UmarAbuAbd,UmarAbuAbd,1,1,0,1,3,0,0.024711015
2779987029,AbuKhalidSoori,AbuKhalidSoori,1,1,0,1,3,0,0.024711015
2266741854,Al_Furqan10,Al_Furqan10,1,2,0,2,3,1,0.073645766
150495079,Sam_Holzenbein,Sam_Holzenbein,1,1,0,1,3,0,0.024711015
373144687,kamilcom2000,kamilcom2000,1,1,0,1,3,0,0.024711015
2650291327,Asadromade,Asadromade,1,4,0,4,3,0.75,0.117499061
23575680,ZindarudHD,ZindarudHD,1,1,0,1,3,0,0.024711015
494025869,aseef_sh,aseef_sh,1,0,2,2,3,1,0
2196749467,abo_ratep,abo_ratep,1,0,2,2,3,1,0
186203359,BORDZGOR,BORDZGOR,1,1,0,1,3,0,0.024711015
2835594558,hydra_q1,hydra_q1,1,0,1,1,3,0,0
1122241099,hesune123,hesune123,1,0,1,1,3,0,0
1364114935,Abohamzaraqah,Abohamzaraqah,1,0,1,1,3,0,0
861424225,aleesa71,aleesa71,1,0,2,2,3,1,0
2803351279,FaizSalum,FaizSalum,1,1,0,1,3,0,0.024711015
255680682,zhiwar_jamil,zhiwar_jamil,1,2,0,2,3,1,0.073645766
1518092054,LiwaaAlhaq,LiwaaAlhaq,1,0,1,1,3,0,0
2772582243,Abaz1988,Abaz1988,1,1,0,1,3,0,0.024711015
85114724,aayanshax,aayanshax,1,3,0,3,3,0.6666667,0.084107467
2675031940,saifulislaam007,saifulislaam007,1,2,0,2,3,1,0.073645766
2278899601,Abu_Usamah1,Abu_Usamah1,1,1,0,1,3,0,0.024711015
2830224025,yemen__AFFAIR,yemen__AFFAIR,1,0,1,1,3,0,0
2801942426,darulqadaaeng,darulqadaaeng,1,0,1,1,3,0,0
235159513,nishad689,nishad689,1,1,0,1,3,0,0.024711015
2788900827,CBasthaa,CBasthaa,1,1,0,1,3,0,0.024711015
864665564,Wazir_Witness,Wazir_Witness,1,2,0,2,3,0.5,0.058102608
819216373,b_ben88,b_ben88,1,2,0,2,3,1,0.073645766
304365581,BuMeJa,BuMeJa,1,2,0,2,3,0.5,0.058102608
1731674126,A_langley1990,A_langley1990,1,1,0,1,3,0,0.024711015
2840412228,alquran7890,alquran7890,1,1,0,1,3,0,0.024711015
2570502288,MuhajirAlIslam,MuhajirAlIslam,1,1,0,1,3,0,0.024711015
2610774175,aalbattar,aalbattar,1,0,1,1,3,0,0
2270871787,mohshin92,mohshin92,1,1,0,1,3,0,0.024711015
2426093822,mrali323,mrali323,1,1,0,1,3,0,0.024711015
624640256,slmh_s,slmh_s,1,0,1,1,3,0,0
2856930013,IbnSaifullah,IbnSaifullah,1,1,0,1,3,0,0.024711015
1286258996,m_aladani,m_aladani,1,0,1,1,3,0,0
470860158,SahelMohammad,SahelMohammad,1,1,0,1,3,0,0.024711015
379634072,salamghalib,salamghalib,1,3,0,3,3,0.8333333,0.10703736
2861015114,almardelli,almardelli,1,1,0,1,3,0,0.024711015
2733818314,Uncensoredhrira,Uncensoredhrira,1,2,0,2,3,0.5,0.058102608
2749809151,SalafiPasTalafi,SalafiPasTalafi,1,2,0,2,3,1,0.073645766
1034469997,hicham93936,hicham93936,1,1,0,1,3,0,0.024711015
231064186,yosep_r,yosep_r,1,1,0,1,3,0,0.024711015
1645527739,mujahidisham,mujahidisham,1,0,1,1,3,0,0
1951515330,omer_behram,omer_behram,1,1,0,1,3,0,0.024711015
1516847846,MesediElvin,MesediElvin,1,1,0,1,3,0,0.024711015
1344029437,MeSajjjad,MeSajjjad,1,2,0,2,3,1,0.073645766
70120954,partofummah,partofummah,1,2,0,2,3,1,0.073645766
2531148578,jihadahmedsmg,jihadahmedsmg,1,1,0,1,3,0,0.024711015
194462542,Ibnelhassan_,Ibnelhassan_,1,2,0,2,3,0.5,0.035172715
1034732406,aimanaibrahem,aimanaibrahem,1,0,1,1,3,0,0
2543076362,Almojahedinarmy,Almojahedinarmy,1,0,1,1,3,0,0
478626868,haha_771,haha_771,1,1,0,1,3,0,0.024711015
2571453512,khalidsafi97,khalidsafi97,1,1,0,1,3,0,0.024711015
2828223576,hussaindeen98,hussaindeen98,1,1,0,1,3,0,0.024711015
1347798108,abu_khalid786,abu_khalid786,1,1,0,1,3,0,0.024711015
1150498320,hayrettindisko,hayrettindisko,1,1,0,1,3,0,0.024711015
707052698,IslamArmy01,IslamArmy01,1,0,1,1,3,0,0
222119096,SURROGAT1980,SURROGAT1980,1,1,0,1,3,0,0.024711015
2818458908,abuuDahab,abuuDahab,1,1,0,1,3,0,0.024711015
2675852681,fe12eex,fe12eex,1,2,0,2,3,0,0.035537131
2493531535,abja77,abja77,1,0,2,2,3,0.5,0
37733782,Linhav,Linhav,1,1,0,1,3,0,0.024711015
2261861805,zhoof1,zhoof1,1,0,1,1,3,0,0
91342257,ina_unique,ina_unique,1,1,0,1,3,0,0.024711015
2246216617,WestAleppo,WestAleppo,1,0,1,1,3,0,0
2669790764,AboZanjabeel,AboZanjabeel,1,1,0,1,3,0,0.024711015
295111606,edyscapes,edyscapes,1,3,0,3,3,0.16666667,0.061872854
1242285650,AbuhAlam,AbuhAlam,1,2,0,2,3,0.5,0.058102608
2428388951,AlMNARA_ALBIDA,AlMNARA_ALBIDA,1,0,1,1,3,0,0
1431258793,abuabeida,abuabeida,1,0,2,2,3,0.5,0
2775664383,sajeelonline,sajeelonline,1,1,0,1,3,0,0.024711015
2805319502,Abo_Alyazeed_T,Abo_Alyazeed_T,1,0,1,1,3,0,0
2451752851,tefecininkesesi,tefecininkesesi,1,1,0,1,3,0,0.024711015
500942742,malhamah,malhamah,1,0,2,2,3,0.5,0
1118347591,gwr11309,gwr11309,1,2,0,2,3,1,0.073645766
920831946,NIZAMSHAIKH313,NIZAMSHAIKH313,1,1,0,1,3,0,0.024711015
194070496,HablulMetin,HablulMetin,1,1,0,1,3,0,0.024711015
1237534764,IrjaSlayer,IrjaSlayer,1,1,5,6,3,0.8,0.033391593
2836056206,moj1999,moj1999,1,1,1,2,3,0,0.024711015
2783594658,habske,habske,1,1,0,1,3,0,0.024711015
2282375332,snowmuslimah,snowmuslimah,1,2,0,2,3,1,0.073645766
499665078,abu_khalisah,abu_khalisah,1,1,0,1,3,0,0.024711015
831244502,RobertJRiggs,RobertJRiggs,1,1,0,1,3,0,0.024711015
101239058,PALAULYSSES,PALAULYSSES,1,1,0,1,3,0,0.024711015
53169206,baumtweet,baumtweet,1,0,1,1,3,0,0
77711690,_Macho69,_Macho69,1,1,0,1,3,0,0.024711015
2624309704,moderatemoe,moderatemoe,1,1,0,1,3,0,0.024711015
2780940789,abdalwahab_21,abdalwahab_21,1,0,1,1,3,0,0
480528909,MalcolmX786,MalcolmX786,1,1,0,1,3,0,0.024711015
2205338203,islamic_front,islamic_front,1,0,3,3,3,0.8333333,0
1605978720,BhatFaruq,BhatFaruq,1,1,0,1,3,0,0.024711015
2772683398,Assomaliyah,Assomaliyah,1,4,0,4,3,0.5,0.110807606
2827995829,ridhwan411,ridhwan411,1,3,0,3,3,0.8333333,0.10703736
719866588,Ahrar4islam,Ahrar4islam,1,0,1,1,3,0,0
2831436592,aboazaam122,aboazaam122,1,0,1,1,3,0,0
1412352890,mhesne_,mhesne_,1,0,1,1,3,0,0
268979148,spacenocturnes,spacenocturnes,1,3,0,3,3,0.8333333,0.10703736
2264222720,Azmarai9,Azmarai9,1,0,1,1,3,0,0
2819073765,nuralhaqq,nuralhaqq,1,1,0,1,3,0,0.024711015
2423901228,abo196,abo196,1,1,0,1,3,0,0.024711015
1491389486,SarayaMarwan,SarayaMarwan,1,0,1,1,3,0,0
2623982697,UmmMuhajirah,UmmMuhajirah,1,2,0,2,3,0.5,0.058102608
2600717424,vpseif55,vpseif55,1,1,0,1,3,0,0.024711015
2816560256,abuumar313,abuumar313,1,1,0,1,3,0,0.024711015
2757479649,shariahislamiya,shariahislamiya,1,1,0,1,3,0,0.024711015
2814332148,AbuMohamadSa,AbuMohamadSa,1,0,1,1,3,0,0
2616708397,AzTunsi,AzTunsi,1,1,0,1,3,0,0.024711015
2543996293,ribatmedya,ribatmedya,1,0,2,2,3,0.5,0
2717846765,SSuhaylansari,SSuhaylansari,1,2,0,2,3,1,0.073645766
2722287016,TheDutchWitness,TheDutchWitness,1,2,1,3,3,1,0.073645766
2578173181,khaleelalfurhud,khaleelalfurhud,1,2,0,2,3,0,0.028481261
619466227,ro34th,ro34th,1,1,0,1,3,0,0.024711015
2239352387,UHudayr,UHudayr,1,2,0,2,3,0.5,0.035172715
2784677459,NusReenAdyn,NusReenAdyn,1,1,0,1,3,0,0.024711015
1348914792,suyi352,suyi352,1,1,0,1,3,0,0.024711015
2808336020,RealIgazz,RealIgazz,1,3,0,3,3,0.5,0.077416012
2342047508,mmhab_alnsra,mmhab_alnsra,1,1,0,1,3,0,0.024711015
2751942448,jundi_ddawla,jundi_ddawla,1,1,0,1,3,0,0.024711015
2449559347,ggg1575,ggg1575,1,4,0,4,3,0.41666666,0.087877713
720621379,fairs_ibrahim,fairs_ibrahim,1,3,0,3,3,0.8333333,0.10703736
25284602,Jamzen,Jamzen,1,1,0,1,3,0,0.024711015
2806435979,HemaHarman,HemaHarman,1,1,0,1,3,0,0.024711015
2755121316,mohamedali67555,mohamedali67555,1,3,0,3,3,0.16666667,0.038942962
2489471167,IslamArmy_Eng,IslamArmy_Eng,1,0,3,3,3,0.8333333,0
1076777191,erfanyousafzai,erfanyousafzai,1,1,0,1,3,0,0.024711015
735826188,Ataghermini,Ataghermini,1,1,0,1,3,0,0.024711015
715116854,MiddlePath25,MiddlePath25,1,1,0,1,3,0,0.024711015
2462732617,MadsmeekAlves,MadsmeekAlves,1,3,0,3,3,0.8333333,0.10703736
2834944368,isofiraq60,isofiraq60,1,3,0,3,3,0.8333333,0.10703736
2633552251,tkghori,tkghori,1,3,0,3,3,0.8333333,0.10703736
2832519551,ibrahimibruz,ibrahimibruz,1,1,0,1,3,0,0.024711015
2814595480,raedaloui1,raedaloui1,1,1,0,1,3,0,0.024711015
810766897,HilmiUloom,HilmiUloom,1,1,0,1,3,0,0.024711015
2232930895,Qadar1435,Qadar1435,1,3,0,3,3,0.16666667,0.038942962
2730414717,1ab6fedcd7e0403,1ab6fedcd7e0403,1,2,0,2,3,0.5,0.035172715
1610207894,DarknetFreud,DarknetFreud,1,1,0,1,3,0,0.024711015
2784940727,ZendeliEroll,ZendeliEroll,1,1,0,1,3,0,0.024711015
2809746206,kh_khana,kh_khana,1,3,0,3,3,0.16666667,0.039307377
2277430134,AbuMamadou,AbuMamadou,1,0,2,2,3,1,0
2592986047,S_H_MM,S_H_MM,1,0,2,2,3,0.5,0
2865117356,MahfuzalMahfuz,MahfuzalMahfuz,1,1,0,1,3,0,0.024711015
488854545,AaronOsowski,AaronOsowski,1,1,0,1,3,0,0.024711015
1544049684,LeRazi,LeRazi,1,4,0,4,3,0.5,0.110807606
330621794,tullochlaw,tullochlaw,1,0,1,1,3,0,0
2797884558,iskandar2222,iskandar2222,1,1,0,1,3,0,0.024711015
310924451,MICHAELKELS0,MICHAELKELS0,1,1,0,1,3,0,0.024711015
2855860424,truthcekr,truthcekr,1,1,0,1,3,0,0.024711015
2783728895,aboahma82052542,aboahma82052542,1,1,0,1,3,0,0.024711015
472962312,RamiAlLolah,RamiAlLolah,1,0,4,4,3,0.41666666,0
1630983498,FarooqUmer86,FarooqUmer86,1,1,0,1,3,0,0.024711015
2200622606,Naaqid,Naaqid,1,3,0,3,3,0.8333333,0.123938486
2832619091,ahmetmard,ahmetmard,1,1,0,1,3,0,0.024711015
2827441799,abuosama1112,abuosama1112,1,1,0,1,3,0,0.024711015
1119409806,rkorvd44,rkorvd44,1,0,2,2,3,1,0
2582959765,Latakia_JN,Latakia_JN,1,0,2,2,3,0.5,0
2287286557,jabhat__,jabhat__,1,2,0,2,3,0,0.028481261
2820265651,alah_sh,alah_sh,1,0,1,1,3,0,0
184669907,foisal11,foisal11,1,1,0,1,3,0,0.024711015
988272445,abuowaisalibi,abuowaisalibi,1,0,1,1,3,0,0
379672417,alaodiani,alaodiani,1,0,1,1,3,0,0
69264360,_Ms_R,_Ms_R,1,1,0,1,3,0,0.024711015
2820036488,B_ghuraba,B_ghuraba,1,3,0,3,3,0.5,0.077416012
1388369810,almakds,almakds,1,0,1,1,3,0,0
397957022,UmmDaria,UmmDaria,1,5,0,5,3,0.5,0.121269307
830986212,nadeemsalfi,nadeemsalfi,1,1,0,1,3,0,0.024711015
1089230862,FlannyA,FlannyA,1,0,1,1,3,0,0
94394485,Mo8_,Mo8_,1,3,0,3,3,0.5,0.084471882
1499420803,zulfijaadeyn,zulfijaadeyn,1,1,0,1,3,0,0.024711015
2649249943,AbouHandhala,AbouHandhala,1,1,0,1,3,0,0.024711015
17717430,mkink,mkink,1,0,1,1,3,0,0
2679983819,Anti_PKK1,Anti_PKK1,1,1,1,2,3,0,0.024711015
2674612447,20Moneim,20Moneim,1,1,0,1,3,0,0.024711015
2307873010,JoelTambussi,JoelTambussi,1,1,0,1,3,0,0.024711015
2455364660,blackbanneryaz,blackbanneryaz,1,1,0,1,3,0,0.024711015
1907317094,Hanna_rara2,Hanna_rara2,1,2,0,2,3,0.5,0.058102608
59824526,JessLappin,JessLappin,1,0,1,1,3,0,0
2782976461,UthmanAlTurk,UthmanAlTurk,1,3,0,3,3,0.8333333,0.10703736
1161288163,mohummd123,mohummd123,1,1,0,1,3,0,0.024711015
1711167979,g_z_1,g_z_1,1,0,1,1,3,0,0
2777930243,EbosnicEbu,EbosnicEbu,1,1,0,1,3,0,0.024711015
2490522203,aladani998,aladani998,1,0,1,1,3,0,0
603216540,torikdib,torikdib,1,2,0,2,3,0.5,0.035172715
314170013,marcialythcott,marcialythcott,1,0,1,1,3,0,0
2794412717,abu_alainaa,abu_alainaa,1,0,1,1,3,0,0
147282640,engraatish,engraatish,1,1,0,1,3,0,0.024711015
243030753,nicksporter,nicksporter,1,0,1,1,3,0,0
595971885,helenaa91,helenaa91,1,1,0,1,3,0,0.024711015
853790514,muneerabdullah2,muneerabdullah2,1,1,0,1,3,0,0.024711015
952458050,pluppsverige,pluppsverige,1,1,0,1,3,0,0.024711015
2382322603,abu_naflah,abu_naflah,1,2,0,2,3,0.5,0.058102608
31480794,GhostRiderRadio,GhostRiderRadio,1,1,0,1,3,0,0.024711015
1302453252,Moredie73,Moredie73,1,3,0,3,3,0.8333333,0.10703736
438393878,safaa159,safaa159,1,0,1,1,3,0,0
921885776,Ibrahimalsaleh3,Ibrahimalsaleh3,1,1,0,1,3,0,0.024711015
2822724714,drdoctordr1,drdoctordr1,1,3,0,3,3,0.16666667,0.038942962
37182597,_DavidThomson,_DavidThomson,1,3,0,3,3,0.16666667,0.039307377
2284051675,Interbrigades,Interbrigades,1,1,0,1,3,0,0.024711015
25713923,jesusalmeyda,jesusalmeyda,1,1,0,1,3,0,0.024711015
475061587,Ibrahimyafea,Ibrahimyafea,1,0,1,1,3,0,0
2266488150,Amatullah22,Amatullah22,1,2,0,2,3,0.5,0.058102608
2772655480,Souli88Amg,Souli88Amg,1,3,0,3,3,0.6666667,0.084107467
2490654080,d_brss,d_brss,1,0,1,1,3,0,0
1928060414,ansaralmujahidn,ansaralmujahidn,1,1,0,1,3,0,0.024711015
2793055495,inqilaabikhan,inqilaabikhan,1,2,0,2,3,0.5,0.075003734
2820660784,kaled0954699402,kaled0954699402,1,1,0,1,3,0,0.024711015
2797981625,qahtani1435,qahtani1435,1,0,1,1,3,0,0
1917476466,saef20135,saef20135,1,0,1,1,3,0,0
2481544842,mat33z1,mat33z1,1,1,0,1,3,0,0.024711015
2225528484,PathOTProphets,PathOTProphets,1,1,0,1,3,0,0.024711015
2796117671,rayat_t,rayat_t,1,1,3,4,3,0.75,0.010461701
2724224705,AlsoYss,AlsoYss,1,1,0,1,3,0,0.024711015
2809061065,ravidas9085,ravidas9085,1,3,0,3,3,0.8333333,0.10703736
938958542,alasalawatanmya,alasalawatanmya,1,0,1,1,3,0,0
1347804901,MstoSattuf,MstoSattuf,1,0,1,1,3,0,0
2822397678,TalibanN20MMMF9,TalibanN20MMMF9,1,1,1,2,3,0,0.024711015
1340202776,islamic_lens,islamic_lens,1,0,2,2,3,1,0
329965340,szazai,szazai,1,1,0,1,3,0,0.024711015
256958256,liuxufenfenfei8,liuxufenfenfei8,1,2,0,2,3,1,0.073645766
2359484214,eynie_aslam,eynie_aslam,1,2,0,2,3,1,0.073645766
2778685254,3Ansar_B_Almqds,3Ansar_B_Almqds,1,0,1,1,3,0,0
2799755104,AbuMaryam100,AbuMaryam100,1,1,0,1,3,0,0.024711015
357022353,sam20114,sam20114,1,0,1,1,3,0,0
388652939,abozainb1,abozainb1,1,0,1,1,3,0,0
403562496,rameexahm,rameexahm,1,1,0,1,3,0,0.024711015
126214175,some_MusliM,some_MusliM,1,1,2,3,3,0.6666667,0.024711015
2568413233,Sareerafrid,Sareerafrid,1,1,0,1,3,0,0.024711015
433381465,Iraqi_stranger,Iraqi_stranger,1,0,1,1,3,0,0
528474374,bzilips,bzilips,1,1,0,1,3,0,0.024711015
2348998938,saifaain,saifaain,1,1,0,1,3,0,0.024711015
1578000702,Ujalay_UR,Ujalay_UR,1,1,0,1,3,0,0.024711015
2835812412,willothewispp,willothewispp,1,3,0,3,3,0.8333333,0.10703736
1867997570,merripal,merripal,1,3,0,3,3,0.8333333,0.10703736
1117217190,Basharfahmi,Basharfahmi,1,1,0,1,3,0,0.024711015
2259345866,amernaser2012,amernaser2012,1,0,1,1,3,0,0
2405327313,SChazua,SChazua,1,2,0,2,3,1,0.073645766
2609701446,Vahdetislami,Vahdetislami,1,2,0,2,3,0.5,0.058102608
1555358371,sm65sm46,sm65sm46,1,0,1,1,3,0,0
434266793,M_P001,M_P001,1,3,0,3,3,0.6666667,0.068564309
2600067792,Abu_Moosa1,Abu_Moosa1,1,1,0,1,3,0,0.024711015
2825034803,mernahro,mernahro,1,1,0,1,3,0,0.024711015
1277682402,JSharza,JSharza,1,1,0,1,3,0,0.024711015
2709732137,TomsonLa,TomsonLa,1,2,0,2,3,0,0.028481261
2779243277,JulayElmm,JulayElmm,1,1,0,1,3,0,0.024711015
1297965848,DawodElmir,DawodElmir,1,1,0,1,3,0,0.024711015
2546033492,HashemOsseiran,HashemOsseiran,1,1,0,1,3,0,0.024711015
2245747573,front_syrian,front_syrian,1,0,1,1,3,0,0
281895821,Alhazimy,Alhazimy,1,1,0,1,3,0,0.024711015
1499292588,aboomar076,aboomar076,1,0,1,1,3,0,0
2762269642,nazd345,nazd345,1,5,0,5,3,0.4,0.121633722
1942053866,A1_GHURABAH,A1_GHURABAH,1,1,0,1,3,0,0.024711015
1381491726,JohnSimpsonlink,JohnSimpsonlink,1,5,0,5,3,0.35,0.098703829
2807292988,AkA_2014_,AkA_2014_,1,2,0,2,3,0.5,0.035172715
1294427227,bktkml,bktkml,1,1,0,1,3,0,0.024711015
25879646,BeckyKazana,BeckyKazana,1,0,1,1,3,0,0
2851628167,OmarBeiiy,OmarBeiiy,1,1,0,1,3,0,0.024711015
2780357817,1b6765707cfd4d6,1b6765707cfd4d6,1,1,0,1,3,0,0.024711015
1102210272,WasAlRahman,WasAlRahman,1,1,0,1,3,0,0.024711015
2303583463,wmm7876,wmm7876,1,0,1,1,3,0,0
1969251565,ajnad11alsham,ajnad11alsham,1,0,1,1,3,0,0
24372592,TomCoghlan,TomCoghlan,1,4,0,4,3,0.5,0.110807606
2777474440,fdr4798,fdr4798,1,1,0,1,3,0,0.024711015
1314055566,julaibib1,julaibib1,1,0,1,1,3,0,0
407168428,al_furqan_fn,al_furqan_fn,1,3,0,3,3,0.8333333,0.10703736
2249123324,khubaib1992,khubaib1992,1,1,0,1,3,0,0.024711015
2782324259,SulaimahAbdul,SulaimahAbdul,1,1,0,1,3,0,0.024711015
2808977761,AbuAbdulrhman_,AbuAbdulrhman_,1,1,0,1,3,0,0.024711015
717841975,Xycehxan,Xycehxan,1,2,0,2,3,0,0.028481261
1013605980,aqushchi,aqushchi,1,4,0,4,3,0.41666666,0.087877713
2343659174,Ajnad_Sham,Ajnad_Sham,1,0,1,1,3,0,0
54453877,Ibrahim_Khan,Ibrahim_Khan,1,0,1,1,3,0,0
2444125892,mustapha_alger,mustapha_alger,1,1,0,1,3,0,0.024711015
2820209613,MKurdiyah,MKurdiyah,1,2,0,2,3,0,0.028481261
2811487953,majdimaram,majdimaram,1,1,0,1,3,0,0.024711015
2756536039,66A6_,66A6_,1,1,0,1,3,0,0.024711015
1270212445,bathily_ousmane,bathily_ousmane,1,1,0,1,3,0,0.024711015
263225101,ALHmadani,ALHmadani,1,0,1,1,3,0,0
1031792569,S_IslamicFront,S_IslamicFront,1,0,2,2,3,1,0
213182436,Bridget_PJM,Bridget_PJM,1,1,0,1,3,0,0.024711015
2801362930,BintWater,BintWater,1,0,2,2,3,1,0
408479814,Aadilzargar,Aadilzargar,1,2,0,2,3,0.5,0.058102608
2279106649,AbuOsman11119,AbuOsman11119,1,1,0,1,3,0,0.024711015
2424891526,abuhussain9275,abuhussain9275,1,0,1,1,3,0,0
253323475,jbck24,jbck24,1,1,0,1,3,0,0.024711015
2782717557,UmmahMonitor,UmmahMonitor,1,1,0,1,3,0,0.024711015
2188765454,Abo_Saleh_T,Abo_Saleh_T,1,0,1,1,3,0,0
2813191903,AdamB2B1,AdamB2B1,1,2,1,3,3,0.5,0.058102608
18671937,V_FreaKy,V_FreaKy,1,1,0,1,3,0,0.024711015
2828161421,abi_mavi,abi_mavi,1,1,0,1,3,0,0.024711015
2610719064,teddymedina4,teddymedina4,1,1,0,1,3,0,0.024711015
1065150858,Soufiane004,Soufiane004,1,2,0,2,3,1,0.073645766
2537580957,abu_imaad,abu_imaad,1,1,0,1,3,0,0.024711015
2349885854,hildo58,hildo58,1,2,0,2,3,1,0.073645766
2643710369,AbuFullaan,AbuFullaan,1,2,0,2,3,1,0.073645766
2735729108,mohammed_2990,mohammed_2990,1,2,0,2,3,1,0.073645766
2692573726,ilhameyasin321,ilhameyasin321,1,3,0,3,3,0.6666667,0.084107467
2705812085,mzpinguin,mzpinguin,1,1,0,1,3,0,0.024711015
584936124,us_4_all,us_4_all,1,0,1,1,3,0,0
2495933175,MomosauerG,MomosauerG,1,3,0,3,3,0.8333333,0.10703736
877882134,DQ_HaXxa,DQ_HaXxa,1,2,0,2,3,1,0.073645766
540207913,ssoo1995,ssoo1995,1,0,1,1,3,0,0
17066868,ummulabeerah,ummulabeerah,1,1,0,1,3,0,0.024711015
2584537987,MujahidaHafy,MujahidaHafy,1,1,0,1,3,0,0.024711015
2581769610,munawargilani1,munawargilani1,1,1,0,1,3,0,0.024711015
510553015,InfoGlobi_Lajme,InfoGlobi_Lajme,1,3,0,3,3,0.8333333,0.10703736
2204756970,taimallah1435,taimallah1435,1,0,1,1,3,0,0
2694736958,AbuHanna554,AbuHanna554,1,4,0,4,3,0.41666666,0.087877713
2827709575,fostatalgootah,fostatalgootah,1,0,1,1,3,0,0
361196702,Rehmanrj,Rehmanrj,1,2,0,2,3,0.5,0.058102608
502492330,ahmad_syr7,ahmad_syr7,1,1,0,1,3,0,0.024711015
2790714663,ahkishaykh,ahkishaykh,1,2,0,2,3,1,0.073645766
1976921455,abed_salame,abed_salame,1,0,2,2,3,1,0
2204986748,shame_5,shame_5,1,0,1,1,3,0,0
2725735881,vu_vu_zella,vu_vu_zella,1,1,0,1,3,0,0.024711015
2835475915,UmmBest,UmmBest,1,3,0,3,3,0.16666667,0.061872854
2769703501,abuameer0067,abuameer0067,1,1,0,1,3,0,0.024711015
97086952,RandyEBarnett,RandyEBarnett,1,0,1,1,3,0,0
1645051140,Mohamme15862197,Mohamme15862197,1,1,0,1,3,0,0.024711015
2263281214,3krmh_11,3krmh_11,1,0,1,1,3,0,0
2802544191,adnanh_h,adnanh_h,1,5,0,5,3,0.5,0.121269307
2478101123,ahmad_sherwan,ahmad_sherwan,1,1,0,1,3,0,0.024711015
486895455,aliimran2991991,aliimran2991991,1,2,0,2,3,0.5,0.058102608
2663901169,seyfshishani,seyfshishani,1,1,0,1,3,0,0.024711015
557543336,abdulaziztarefe,abdulaziztarefe,1,0,2,2,3,0.5,0
2270654395,ZDaikhi,ZDaikhi,1,1,0,1,3,0,0.024711015
130215899,lac_news,lac_news,1,0,1,1,3,0,0
2830266360,Saeed__AlHalabi,Saeed__AlHalabi,1,4,4,8,3,0.8,0.157330079
612560892,alommahbrigade,alommahbrigade,1,0,1,1,3,0,0
2854023176,mohammadtarik81,mohammadtarik81,1,1,0,1,3,0,0.024711015
252866695,phathomdd,phathomdd,1,1,0,1,3,0,0.024711015
2437116041,edgard6156,edgard6156,1,1,0,1,3,0,0.024711015
87257307,pallap1,pallap1,1,1,0,1,3,0,0.024711015
2383147232,SalmanfFaris,SalmanfFaris,1,1,0,1,3,0,0.024711015
2625663276,Abu_Nusratullah,Abu_Nusratullah,1,2,0,2,3,0.5,0.035172715
2233299315,Hayyalaljihad,Hayyalaljihad,1,3,0,3,3,0.8333333,0.10703736
2617376167,noahmac82,noahmac82,1,3,0,3,3,0.8333333,0.10703736
2827252233,aboelaith25,aboelaith25,1,1,0,1,3,0,0.024711015
2495640093,Green_bird90,Green_bird90,1,5,1,6,3,0.8,0.16779178
383906376,ccoyne46,ccoyne46,1,1,0,1,3,0,0.024711015
1478685416,abu_almgdam,abu_almgdam,1,0,1,1,3,0,0
2739761936,TheSucuk,TheSucuk,1,2,0,2,3,0.5,0.058102608
1186467456,ABO_ALBARAA_,ABO_ALBARAA_,1,0,1,1,3,0,0
244839293,medhatbrooklyn,medhatbrooklyn,1,0,1,1,3,0,0
130184065,DanieleRaineri,DanieleRaineri,1,1,3,4,3,0.8333333,0.024711015
2851369891,5WqJyMhozshkJRO,5WqJyMhozshkJRO,1,1,0,1,3,0,0.024711015
2480665526,_a_b_d_,_a_b_d_,1,0,1,1,3,0,0
1035203550,shiful333,shiful333,1,1,0,1,3,0,0.024711015
2652435426,haytchy_kay,haytchy_kay,1,1,0,1,3,0,0.024711015
2818438145,JohnDeliro,JohnDeliro,1,1,0,1,3,0,0.024711015
2185884700,silybilyx,silybilyx,1,1,0,1,3,0,0.024711015
2645761188,qassam_arabic1,qassam_arabic1,1,0,1,1,3,0,0
573764710,CaucasusAffairs,CaucasusAffairs,1,0,2,2,3,0.5,0
2577134722,Abdulfiislam,Abdulfiislam,1,3,0,3,3,0.6666667,0.084107467
1331328180,shadeealmahdee,shadeealmahdee,1,0,1,1,3,0,0
1696298172,zeen_aldeen,zeen_aldeen,1,0,1,1,3,0,0
2818929886,ummabdussalam,ummabdussalam,1,1,0,1,3,0,0.024711015
1388967152,abureza5,abureza5,1,1,0,1,3,0,0.024711015
2426303730,moudjahid05,moudjahid05,1,1,0,1,3,0,0.024711015
1898673510,ibnharam,ibnharam,1,2,0,2,3,0.5,0.058102608
14153065,MarcvanHedel,MarcvanHedel,1,0,1,1,3,0,0
2661973572,annonimehelper,annonimehelper,1,2,0,2,3,0.5,0.035172715
1249473980,UmmAnwar6,UmmAnwar6,1,1,0,1,3,0,0.024711015
540538386,Jeblawe_7ur,Jeblawe_7ur,1,1,1,2,3,0.5,0.033391593
40760866,DrShaffopolis,DrShaffopolis,1,0,1,1,3,0,0
1224013356,bdarifhasan,bdarifhasan,1,1,0,1,3,0,0.024711015
2210625073,Muhammad_borec,Muhammad_borec,1,2,0,2,3,0.5,0.058102608
2759944462,mohamadalshahab,mohamadalshahab,1,1,0,1,3,0,0.024711015
2177037956,rawa110,rawa110,1,0,1,1,3,0,0
543487657,ibi_070,ibi_070,1,1,0,1,3,0,0.024711015
1020425911,AbuDiraar,AbuDiraar,1,1,0,1,3,0,0.024711015
2580412093,Mizan999999,Mizan999999,1,2,0,2,3,0.5,0.058102608
2793633527,Aidrusali2014Qa,Aidrusali2014Qa,1,3,0,3,3,0.5,0.077416012
2850551563,AbosamraAshraf,AbosamraAshraf,1,1,0,1,3,0,0.024711015
290584348,ansar6599,ansar6599,1,0,1,1,3,0,0
2264659804,EbuRuana,EbuRuana,1,2,0,2,3,0.5,0.035172715
2522707806,Ali_A_Wahid,Ali_A_Wahid,1,2,0,2,3,1,0.073645766
2270001000,JabhatALnusra22,JabhatALnusra22,1,1,0,1,3,0,0.024711015
919172994,pray_shan,pray_shan,1,1,0,1,3,0,0.024711015
14677919,NewYorker,NewYorker,1,0,1,1,3,0,0
2327592604,AdwanShah,AdwanShah,1,1,0,1,3,0,0.024711015
2822535196,muhammadumar913,muhammadumar913,1,2,0,2,3,1,0.073645766
2672949296,gazzesavasi,gazzesavasi,1,1,0,1,3,0,0.024711015
1349548249,abusaryah1,abusaryah1,1,0,1,1,3,0,0
555968898,rashuje,rashuje,1,1,0,1,3,0,0.024711015
967234621,novaicha5,novaicha5,1,1,0,1,3,0,0.024711015
2722920848,AErhabee,AErhabee,1,4,0,4,3,0.5,0.110807606
2826828246,simon_wtf,simon_wtf,1,3,0,3,3,0.5,0.077416012
2831251928,sosoaammoo,sosoaammoo,1,1,0,1,3,0,0.024711015
1712257544,RashidRants,RashidRants,1,1,0,1,3,0,0.024711015
270367283,salnasi,salnasi,1,0,1,1,3,0,0
1675623042,AboMHDAlFateh,AboMHDAlFateh,1,0,1,1,3,0,0
2785180317,kufrbittaghout,kufrbittaghout,1,2,0,2,3,0.5,0.035172715
2766487330,mohamedraouafi1,mohamedraouafi1,1,1,0,1,3,0,0.024711015
2340191056,rizmo87,rizmo87,1,1,0,1,3,0,0.024711015
943487838,abosofyan7,abosofyan7,1,0,1,1,3,0,0
1259076475,thtt2015,thtt2015,1,0,1,1,3,0,0
2806807469,abukholod890,abukholod890,1,1,0,1,3,0,0.024711015
826964924,myc0nsc1ence,myc0nsc1ence,1,1,0,1,3,0,0.024711015
2843211061,AbuMusaBinKh,AbuMusaBinKh,1,1,0,1,3,0,0.024711015
2505374700,selahadin73,selahadin73,1,2,0,2,3,0.5,0.035172715
435180714,plondurci,plondurci,1,2,0,2,3,1,0.073645766
87096338,Amin16,Amin16,1,1,0,1,3,0,0.024711015
2865691669,Sunnahkitab1,Sunnahkitab1,1,1,0,1,3,0,0.024711015
2834103346,DKhalilzai,DKhalilzai,1,1,0,1,3,0,0.024711015
2816375865,ZankoAbdulla,ZankoAbdulla,1,1,0,1,3,0,0.024711015
2735406160,randommissing,randommissing,1,1,0,1,3,0,0.024711015
2257124437,mjahedalsham,mjahedalsham,1,0,1,1,3,0,0
2387770466,musaabbaghdad,musaabbaghdad,1,3,0,3,3,0.6666667,0.068564309
2830859368,arifgfx,arifgfx,1,1,0,1,3,0,0.024711015
2302475376,dshazi10,dshazi10,1,1,0,1,3,0,0.024711015
1640797423,Yemen4Usa,Yemen4Usa,1,0,1,1,3,0,0
2780233126,Firdaws911,Firdaws911,1,1,0,1,3,0,0.024711015
227442095,Cigouave,Cigouave,1,1,0,1,3,0,0.024711015
2807365060,xheva2010,xheva2010,1,1,0,1,3,0,0.024711015
1144782308,shamfalcons,shamfalcons,1,0,1,1,3,0,0
2598764052,Tameri93,Tameri93,1,1,0,1,3,0,0.024711015
464289318,Hamosh84,Hamosh84,1,1,0,1,3,0,0.024711015
1666023019,nadviahmed,nadviahmed,1,1,0,1,3,0,0.024711015
2591522450,MathiFryy,MathiFryy,1,1,0,1,3,0,0.024711015
2762145497,AlExtrimi,AlExtrimi,1,1,0,1,3,0,0.024711015
2831187725,EstellLeonet,EstellLeonet,1,3,0,3,3,0.8333333,0.10703736
2480340751,ZaydMoslim__,ZaydMoslim__,1,2,0,2,3,1,0.073645766
119209826,4mbo,4mbo,1,1,0,1,3,0,0.024711015
588316566,abdullahi1237,abdullahi1237,1,2,0,2,3,0.5,0.035172715
355931463,iLoveLupahsug,iLoveLupahsug,1,2,0,2,3,0,0.028481261
2831155125,DukhanTheSmoke,DukhanTheSmoke,1,2,0,2,3,1,0.073645766
586055609,mohdromih,mohdromih,1,0,1,1,3,0,0
2800648193,UmmHussain103,UmmHussain103,1,1,1,2,0,0,0.010826116
2774695984,DudeGeorg,DudeGeorg,1,4,0,4,0,0.33333334,0.073992814
210075713,Boble_,Boble_,1,5,0,5,0,0.4,0.085159503
1240924256,wartaperang,wartaperang,1,3,0,3,0,0.5,0.063531114
2816442478,AbuHussain104,AbuHussain104,1,80,753,833,0,0.001357756,0.23230833
2535915634,hatekufrnshirk,hatekufrnshirk,1,5,3,8,0,0.4,0.078020901
800161939,sexpanther666,sexpanther666,1,1,0,1,0,0,0.004028086
2611675292,S____SAMA,S____SAMA,1,6,0,6,0,0.4,0.125661808
34898084,vvanwilgenburg,vvanwilgenburg,1,4,1,5,0,0.4,0.096558292
2751103276,AlBenjali,AlBenjali,1,2,1,3,0,0,0.035537131
1154482490,Biwn_1,Biwn_1,1,1,0,1,0,0,0.010826116
2265743774,anikreal1,anikreal1,1,5,0,5,0,0.4,0.107384408
2212037047,al_maduhuri,al_maduhuri,1,3,0,3,0,0.5,0.063531114
2674655755,slaveofallah3mi,slaveofallah3mi,1,5,0,5,0,0.45,0.100950794
1633026584,Richard11872647,Richard11872647,1,1,0,1,0,0,0.010826116
2816672299,press_syria8,press_syria8,1,0,1,1,0,0,0
2799567441,SulaymanTawheed,SulaymanTawheed,1,1,0,1,0,0,0.010826116
2796814931,blackflags_2014,blackflags_2014,1,3,1,4,0,0.5,0.063531114
2747237024,SinfulAkhi,SinfulAkhi,1,1,0,1,0,0,0.010826116
2690745038,AleikumAssalam,AleikumAssalam,1,1,0,1,0,0,0.010826116
1852965619,ObamaNoseWhstl,ObamaNoseWhstl,1,1,0,1,0,0,0.010826116
2794914759,janoubiraq33,janoubiraq33,1,1,0,1,0,0,0.010826116
2651718600,MostafaFin,MostafaFin,1,2,0,2,0,0,0.021287817
18449371,IIRSS_Global,IIRSS_Global,1,2,0,2,0,0,0.028739101
2812314792,AbuSaalihah1,AbuSaalihah1,1,1,2,3,0,0,0.033391593
2800714924,abu_afreen,abu_afreen,1,3,0,3,0,0.5,0.056733084
2804745430,AbuTuraaab,AbuTuraaab,1,2,2,4,0,0.33333334,0.014854202
2416084189,mujahidmusa123,mujahidmusa123,1,5,2,7,0,0.4,0.107384408
2834203875,Abu_Yusuf3,Abu_Yusuf3,1,2,0,2,0,0.5,0.059760868
2178820993,taghar_pakhtun,taghar_pakhtun,1,4,0,4,0,0.41666666,0.088242128
33522966,AmirPutraJumat,AmirPutraJumat,1,1,0,1,0,0,0.010826116
2775581986,admiman2,admiman2,1,4,1,5,0,0.5833333,0.0675592
2839774561,Jozelhind,Jozelhind,1,3,0,3,0,0.5,0.063788954
2826700146,UmmYounus,UmmYounus,1,1,0,1,0,0,0.010826116
2438170015,LyianaAhmad1,LyianaAhmad1,1,1,0,1,0,0,0.010826116
865437098,hanisibu,hanisibu,1,0,4,4,0,0.41666666,0
2790163887,sweet_sujood,sweet_sujood,1,7,0,7,0,0.42857143,0.161705214
822937010,Ansari793,Ansari793,1,4,2,6,0,0.4,0.113459418
534873616,AnayetRashid,AnayetRashid,1,1,0,1,0,0,0.010826116
1899005460,AbuSaladin,AbuSaladin,1,3,0,3,0,0.16666667,0.045998831
2688845372,AhmedAmriki,AhmedAmriki,1,3,0,3,0,0.5,0.093152461
231573091,FreeFalasteen,FreeFalasteen,1,3,2,5,0,0.5,0.093152461
627639942,azeotropicmixtu,azeotropicmixtu,1,1,0,1,0,0,0.004028086
134809266,Amaandollie1,Amaandollie1,1,1,0,1,0,0,0.010826116
162432699,muhammeddocrat,muhammeddocrat,1,1,0,1,0,0,0.010826116
1287522001,nonarky,nonarky,1,1,0,1,0,0,0.010826116
2668889840,ImranLevi,ImranLevi,1,3,0,3,0,0.16666667,0.039307377
2835089179,abskar98,abskar98,1,3,0,3,0,0.5,0.063531114
2828228238,skaam90,skaam90,1,2,0,2,0,0.5,0.014596362
2285635424,AbuAsiyaa,AbuAsiyaa,1,2,0,2,0,0.5,0.059760868
2841741192,MishaAlghareeb,MishaAlghareeb,1,1,0,1,0,0,0.010826116
424478617,veets_tweets11,veets_tweets11,1,1,0,1,0,0,0.010826116
2793965507,skafisti1,skafisti1,1,5,0,5,0,0.35,0.0919058
2213382189,nahnuqadimoon,nahnuqadimoon,1,3,0,3,0,0.16666667,0.025058063
2695137328,23Rehana,23Rehana,1,3,0,3,0,0.16666667,0.047987956
318933041,SecKermani,SecKermani,1,6,0,6,0,0.43333334,0.111495226
2737702980,IsaOropi,IsaOropi,1,6,0,6,0,0.4,0.132095423
2841302713,rayrashcow26,rayrashcow26,1,5,0,5,0,0.45,0.100950794
174688350,molaher03,molaher03,1,1,1,2,0,0,0.010826116
23234689,nick_logan,nick_logan,1,1,0,1,0,0,0.010826116
478742709,MTA8847,MTA8847,1,1,0,1,0,0,0.010826116
2750351546,preytopredator,preytopredator,1,3,0,3,0,0.16666667,0.039307377
93620418,shamreelaa,shamreelaa,1,1,0,1,0,0,0.010826116
2754120005,muhamed6889,muhamed6889,1,1,0,1,0,0,0.010826116
2653948266,Kar_sami_,Kar_sami_,1,5,0,5,0,0.4,0.121633722
1898613145,AbuRijad,AbuRijad,1,2,0,2,0,0,0.035537131
18450890,EastSouthPaw,EastSouthPaw,1,3,0,3,0,0.5,0.056733084
2782693914,m16813,m16813,1,1,0,1,0,0,0.010826116
2590345764,Maxabbes,Maxabbes,1,1,0,1,0,0,0.004028086
2724071983,UmmHafiza,UmmHafiza,1,1,0,1,0,0,0.010826116
2832370241,BintAbdullah01,BintAbdullah01,1,1,0,1,0,0,0.010826116
2263467589,murasul,murasul,1,1,1,2,0,0,0.010826116
2774010448,SDraud,SDraud,1,7,0,7,0,0.3809524,0.136123509
942770779,7_jcri,7_jcri,1,1,0,1,0,0,0.010826116
1675823766,Knight4Desert,Knight4Desert,1,2,0,2,0,0.5,0.059760868
377785004,Cyber9uy,Cyber9uy,1,7,0,7,0,0.4047619,0.136206241
582781638,ali44616,ali44616,1,3,0,3,0,0.16666667,0.047987956
14617319,iQORTA,iQORTA,1,3,0,3,0,0.5,0.063531114
112102146,SheikhRaashid,SheikhRaashid,1,1,0,1,0,0,0.010826116
314772229,arbenzena,arbenzena,1,3,0,3,0,0.5,0.056733084
2829847317,FreekOutLoud,FreekOutLoud,1,3,0,3,0,0.5,0.063531114
94800708,mfreezal,mfreezal,1,1,0,1,0,0,0.010826116
745343844,Muslim_Warrior,Muslim_Warrior,1,2,0,2,0,0,0.052962838
2336787329,muayfarang555,muayfarang555,1,1,0,1,0,0,0.010826116
2804485009,shkelqooo1,shkelqooo1,1,1,0,1,0,0,0.010826116
607685568,KidMcfly86,KidMcfly86,1,2,0,2,0,1,0.007798333
2792229894,ALWiss5,ALWiss5,1,6,0,6,0,0.4,0.125661808
2213055503,UmmUmarah,UmmUmarah,1,2,1,3,0,0,0.03741968
2816937009,Muthanna88,Muthanna88,1,4,5,9,0,0.35,0.088135553
17763433,drposhlost,drposhlost,1,5,0,5,0,0.4,0.107384408
2613709963,al_furqane,al_furqane,1,1,0,1,0,0,0.010826116
99224718,FulanSudani,FulanSudani,1,2,1,3,0,0.5,0.014596362
2566095385,AlIfrikani,AlIfrikani,1,3,0,3,0,0.5,0.084471882
400166228,ahmadmusajibril,ahmadmusajibril,1,0,6,6,0,0.56666666,0
2711195011,news_scrutiny,news_scrutiny,1,4,0,4,0,0.16666667,0.07269897
356289969,Tweet_pelter,Tweet_pelter,1,3,1,4,0,0.5,0.063531114
2761190671,abunaseha,abunaseha,1,2,0,2,0,0.5,0.014596362
577048171,PaladinOfJihad,PaladinOfJihad,1,3,3,6,0,0.5,0.092788046
2230456042,Farooq970Khan,Farooq970Khan,1,4,0,4,0,0.5,0.134764602
319688454,Khadar_Ahme,Khadar_Ahme,1,1,0,1,0,0,0.004028086
250449688,fikafaraikaa,fikafaraikaa,1,3,0,3,0,0.16666667,0.068928724
2458717988,AbdullahatTurki,AbdullahatTurki,1,3,0,3,0,0.5,0.084471882
2677509949,qhrasheed1,qhrasheed1,1,2,0,2,0,0,0.028739101
2451771199,Ridvan09479368,Ridvan09479368,1,5,0,5,0,0.4,0.107831555
2483687299,AlexBradford87,AlexBradford87,1,2,0,2,0,0.5,0.059760868
2815594422,test_xm,test_xm,1,2,0,2,0,1,0.014854202
2822705135,hasansha_,hasansha_,1,1,0,1,0,0,0.010826116
2687307848,mamun_montarin,mamun_montarin,1,4,0,4,0,0.41666666,0.043335463
2791248064,Sirocco_LY,Sirocco_LY,1,4,0,4,0,0.41666666,0.088242128
2796458183,sa_raduyev,sa_raduyev,1,1,0,1,0,0,0.004028086
2544931069,4firdous,4firdous,1,2,4,6,0,0.5833333,0.052704998
1484034318,KinggKushh,KinggKushh,1,1,0,1,0,0,0.010826116
465604907,safeboss,safeboss,1,4,0,4,0,0.41666666,0.096922707
2306380078,ibrahimalsudani,ibrahimalsudani,1,3,0,3,0,0.33333334,0.070222568
263885132,DHausaMan,DHausaMan,1,4,0,4,0,0.41666666,0.113823833
1522504082,obinoavey,obinoavey,1,3,0,3,0,0.5,0.093152461
111743551,mfhadm,mfhadm,1,4,0,4,0,0.41666666,0.081444099
2315457124,muoncag,muoncag,1,1,0,1,0,0,0.010826116
585994931,En_Sharif,En_Sharif,1,1,0,1,0,0,0.010826116
2504856322,DrIhsan070,DrIhsan070,1,4,0,4,0,0.5,0.117863476
2192806731,Bukhariiiiiiii,Bukhariiiiiiii,1,6,0,6,0,0.43333334,0.118551096
2803012475,Islam4EA5rica,Islam4EA5rica,1,7,0,7,0,0.3809524,0.153024635
2325287905,abusulayman321,abusulayman321,1,1,7,8,0,0.52380955,0.033391593
162960384,Rsherlock,Rsherlock,1,1,0,1,0,0,0.004028086
152540184,nimrullah,nimrullah,1,7,1,8,0,0.42857143,0.161705214
2697204776,y_dohak,y_dohak,1,2,1,3,0,0.5,0.014596362
2455409727,tasalkhan1986,tasalkhan1986,1,2,0,2,0,0.5,0.059760868
2471105690,abumuhammad953,abumuhammad953,1,2,0,2,0,0.5,0.014596362
1709544690,SealOnTheFlag,SealOnTheFlag,1,4,0,4,0,0.5833333,0.0675592
2737280267,fareed_mumin,fareed_mumin,1,2,0,2,0,0,0.035537131
2816480533,AbuZaid1414,AbuZaid1414,1,2,0,2,0,0.5,0.014596362
288199978,laysalghareeb,laysalghareeb,1,3,1,4,0,0.16666667,0.068928724
127931787,MoWithTheO,MoWithTheO,1,1,1,2,0,0,0.010826116
268866979,arafatdhk,arafatdhk,1,4,0,4,0,0.41666666,0.029533297
2787481005,4bu_Muhaj1r,4bu_Muhaj1r,1,37,204,241,0,0.004926108,0.068795772
2855540148,Mujahidin_IS,Mujahidin_IS,1,1,0,1,0,0,0.010826116
2792854977,KaridaKarida,KaridaKarida,1,3,0,3,0,0.16666667,0.047987956
2799670725,shahadah_,shahadah_,1,4,0,4,0,0.5833333,0.0675592
730437092,MADaya786,MADaya786,1,2,0,2,0,0,0.035537131
361731562,RAJONKHAN420,RAJONKHAN420,1,2,0,2,0,0.5,0.014596362
296523244,Kkzahu,Kkzahu,1,6,0,6,0,0.4,0.132095423
2656998954,HuSmeEz11,HuSmeEz11,1,1,0,1,0,0,0.010826116
2802030206,fazme77,fazme77,1,2,0,2,0,0.5,0.059760868
123279009,philippladner,philippladner,1,1,0,1,0,0,0.004028086
2557482703,AbouJa3ffar,AbouJa3ffar,1,3,0,3,0,0.16666667,0.025058063
2727515889,Bosxxlxx,Bosxxlxx,1,3,0,3,0,0.5,0.063788954
2805274374,DaughterAdam,DaughterAdam,1,2,1,3,0,0,0.044217709
65869603,adeebbaig,adeebbaig,1,3,0,3,0,0.5,0.063531114
296687411,Mitjia01,Mitjia01,1,2,0,2,0,0,0.044217709
410892505,bintdeen,bintdeen,1,2,0,2,0,0.5,0.014596362
2716178281,jabirishaq95,jabirishaq95,1,1,0,1,0,0,0.010826116
2735839083,abusafiy1,abusafiy1,1,2,0,2,0,0.5,0.014596362
315037581,ohthatmykee,ohthatmykee,1,1,0,1,0,0,0.010826116
1864439720,Dorphon,Dorphon,1,1,0,1,0,0,0.010826116
305043449,azoarch,azoarch,1,4,0,4,0,0.5833333,0.0675592
1896650768,GreenBirdJannah,GreenBirdJannah,1,5,1,6,0,0.25,0.083160671
2776848733,Hamza_Alamani,Hamza_Alamani,1,2,0,2,0,0,0.035537131
2704545846,naga_laut11,naga_laut11,1,4,0,4,0,0.33333334,0.073992814
2299566160,katabalmajeed,katabalmajeed,1,1,0,1,0,0,0.004028086
81401980,Ibn_Taha,Ibn_Taha,1,3,0,3,0,0.5,0.063531114
1559140490,Tkhaline,Tkhaline,1,1,0,1,0,0,0.010826116
488708243,shahjavad,shahjavad,1,1,0,1,0,0,0.010826116
196974776,Sujeelhussain,Sujeelhussain,1,5,0,5,0,0.5,0.161358166
2531760464,Sidrat032412,Sidrat032412,1,4,0,4,0,0.41666666,0.096922707
2438338922,Bhatirfanhamid,Bhatirfanhamid,1,1,0,1,0,0,0.010826116
2829654513,SeekerMe1,SeekerMe1,1,3,0,3,0,0.16666667,0.047987956
2691897851,DeadredZombie,DeadredZombie,1,1,0,1,0,0,0.010826116
1135321063,Jazon_O,Jazon_O,1,1,0,1,0,0,0.010826116
31463973,drgigiku,drgigiku,1,3,0,3,0,0.5,0.084471882
2828900923,MfaPatrol,MfaPatrol,1,3,0,3,0,0.5,0.063788954
2830178921,brunojackson91,brunojackson91,1,1,0,1,0,0,0.010826116
2839550592,shahidakbar1064,shahidakbar1064,1,1,0,1,0,0,0.010826116
2597001871,syrenarc,syrenarc,1,3,0,3,0,0.5,0.063531114
2825886368,aligok99,aligok99,1,1,0,1,0,0,0.010826116
2272991977,searchenlighten,searchenlighten,1,6,0,6,0,0.36666667,0.102731916
2834766587,revert_queen,revert_queen,1,2,0,2,0,0.5,0.014596362
472488719,DareenElWafa,DareenElWafa,1,1,0,1,0,0,0.010826116
2798984018,5hm00p,5hm00p,1,1,1,2,0,0,0.010826116
2451577776,balek15,balek15,1,2,0,2,0,0.5,0.014596362
25795516,Swareem,Swareem,1,4,0,4,0,0.5,0.103614162
2799016939,Ummu_Zakiyya,Ummu_Zakiyya,1,5,1,6,0,0.45,0.100950794
263428605,anjemchoudary,anjemchoudary,1,0,5,5,0,0.45,0
2615367011,SheikhofEngland,SheikhofEngland,1,2,0,2,0,0.5,0.014596362
1623202892,KhurasaniKhan,KhurasaniKhan,1,3,0,3,0,0.5,0.056733084
1668521124,damuppl,damuppl,1,2,1,3,0,0.33333334,0.021287817
553950391,umm_muthanna,umm_muthanna,1,1,0,1,0,0,0.010826116
2774113506,tHaTgYrlCaStR0,tHaTgYrlCaStR0,1,2,0,2,0,1,0.007798333
1539382543,mudassirmeme,mudassirmeme,1,4,0,4,0,0.25,0.058449656
2820250932,fedoraa1515,fedoraa1515,1,3,0,3,0,0.5,0.063531114
2604867114,Hasan25264,Hasan25264,1,2,0,2,0,1,0.014854202
393289353,YoungGotThis,YoungGotThis,1,1,1,2,0,0,0.004028086
2829819538,nikoboss_17_,nikoboss_17_,1,1,0,1,0,0,0.010826116
722443951,Mishka_Saeed,Mishka_Saeed,1,2,0,2,0,0.5,0.059760868
2568920763,AbuMaryamUK,AbuMaryamUK,1,1,0,1,0,0,0.010826116
438279888,zizqo2see,zizqo2see,1,5,0,5,0,0.4,0.107384408
2395381508,PaulieVerity,PaulieVerity,1,3,0,3,0,0.5,0.063531114
2568986436,AbeShaker,AbeShaker,1,2,1,3,0,0.5,0.059760868
2817269615,secretakhi1,secretakhi1,1,4,1,5,0,0.5833333,0.0675592
1477976084,MemlikPasha,MemlikPasha,1,1,6,7,0,0.4,0.024711015
577282072,mrafiuk,mrafiuk,1,1,0,1,0,0,0.010826116
2838208560,abo_Karim77,abo_Karim77,1,1,0,1,0,0,0.010826116
1351496898,habeshamuslimah,habeshamuslimah,1,1,0,1,0,0,0.010826116
2663882935,thepatienthindi,thepatienthindi,1,5,0,5,0,0.45,0.092270215
2852626692,almuwahhideen,almuwahhideen,1,8,0,8,0,0.44642857,0.186498961
2688164138,TrappedintheUS,TrappedintheUS,1,5,0,5,0,0.4,0.121633722
1119265086,nikki_v85,nikki_v85,1,1,0,1,0,0,0.010826116
2342068546,HamzaBello9,HamzaBello9,1,2,0,2,0,0.5,0.014596362
2686787924,ansaryalhind,ansaryalhind,1,2,0,2,0,0,0.035537131
2593300842,SaifAlRasheed97,SaifAlRasheed97,1,3,0,3,0,0.5,0.063531114
149070235,UID_,UID_,1,1,0,1,0,0,0.010826116
1288970762,benjia100,benjia100,1,1,0,1,0,0,0.010826116
2777063978,mohmad_85,mohmad_85,1,2,0,2,0,1,0.007798333
2709037747,Umm_Khattab,Umm_Khattab,1,3,0,3,0,0.8333333,0.018624449
2698584761,abu_shuhada,abu_shuhada,1,2,1,3,0,0.5,0.014596362
2861769414,AbdurRahman_Aql,AbdurRahman_Aql,1,1,0,1,0,0,0.004028086
2855740104,Mujhid15,Mujhid15,1,1,0,1,0,0,0.010826116
2747245301,96whoisthis,96whoisthis,1,5,0,5,0,0.4,0.121633722
2601755467,AbuAafia1,AbuAafia1,1,5,0,5,0,0.4,0.121633722
68133730,name_find,name_find,1,1,0,1,0,0,0.010826116
2787713910,Bringerpeace,Bringerpeace,1,4,0,4,0,0.41666666,0.088242128
2492965772,Aarif_abbas,Aarif_abbas,1,4,0,4,0,0.41666666,0.096922707
2824741802,fighters7544,fighters7544,1,1,0,1,0,0,0.010826116
1578181746,Chris92x_,Chris92x_,1,1,0,1,0,0,0.010826116
238494947,ddnomade,ddnomade,1,1,0,1,0,0,0.010826116
117253365,mail2sanjaydas,mail2sanjaydas,1,1,0,1,0,0,0.010826116
29956993,dvojnik,dvojnik,1,1,0,1,0,0,0.010826116
760292648,IshteaqHussain,IshteaqHussain,1,1,0,1,0,0,0.010826116
2798003547,JihadiTweets,JihadiTweets,1,6,2,8,0,0.4,0.132095423
2721686904,Nienor19,Nienor19,1,1,0,1,0,0,0.010826116
2786199107,Mujahidah__,Mujahidah__,1,3,0,3,0,0.16666667,0.045998831
2692064663,BurhanSeferi,BurhanSeferi,1,4,0,4,0,0.41666666,0.088242128
2766316952,IbnHimed,IbnHimed,1,1,0,1,0,0,0.010826116
2611717554,nismoash,nismoash,1,3,0,3,0,0.5,0.063531114
2515903931,TweetingAkh,TweetingAkh,1,7,0,7,0,0.35714287,0.113640764
1583392214,Iskander1404,Iskander1404,1,4,0,4,0,0.33333334,0.067194785
2856232495,CamronMcLean519,CamronMcLean519,1,2,0,2,0,1,0.014854202
2795284017,AbuAdamAlAmriki,AbuAdamAlAmriki,1,6,1,7,0,0.43333334,0.165128412
1643324994,Dzakuran_Nahl,Dzakuran_Nahl,1,1,0,1,0,0,0.010826116
2864195180,haqvbatil,haqvbatil,1,2,0,2,0,0.5,0.014596362
40347359,umm_maryamah,umm_maryamah,1,3,0,3,0,0.5,0.063531114
1571104520,rtgearpromo,rtgearpromo,1,3,0,3,0,0.5,0.063788954
46704429,praveenswami,praveenswami,1,0,1,1,0,0,0
2830313267,al_rifai_,al_rifai_,1,3,0,3,0,0.5,0.063531114
2846566244,internet_99,internet_99,1,1,0,1,0,0,0.010826116
2279450564,sudisagal,sudisagal,1,3,0,3,0,0.8333333,0.018624449
1512843254,TerreurNeutre,TerreurNeutre,1,1,0,1,0,0,0.010826116
2781038249,kali31123,kali31123,1,2,0,2,0,0.5,0.059760868
2492967007,aboohanzalah,aboohanzalah,1,5,0,5,0,0.4,0.107384408
2725390435,GreenBird6666,GreenBird6666,1,4,0,4,0,0.41666666,0.111065446
1374529652,TarekMuendelein,TarekMuendelein,1,1,0,1,0,0,0.010826116
234896645,idfwolf1967,idfwolf1967,1,4,0,4,0,0.5,0.117863476
2844174542,SafiyahRahman,SafiyahRahman,1,4,0,4,0,0.41666666,0.097180547
2447714538,Umm_Irfaan,Umm_Irfaan,1,4,0,4,0,0.33333334,0.073992814
1079879984,superflyhigh1,superflyhigh1,1,1,0,1,0,0,0.010826116
1390553412,itsnadias,itsnadias,1,4,1,5,0,0.41666666,0.090124678
70592901,ashrafemp,ashrafemp,1,4,1,5,0,0.5,0.103614162
2716543379,ummRoomaan,ummRoomaan,1,3,0,3,0,0.5,0.063788954
2532354633,muhammad_riyaaz,muhammad_riyaaz,1,2,0,2,0,0,0.044217709
358459982,p_vanostaeyen,p_vanostaeyen,1,4,5,9,0,0.4047619,0.087877713
2742659663,umm_kulthoom,umm_kulthoom,1,2,0,2,0,0.5,0.059760868
2801347226,hikmat2359,hikmat2359,1,3,0,3,0,0.5,0.063531114
2844404412,alwalaawalbara,alwalaawalbara,1,5,1,6,0,0.45,0.100950794
44083927,justanotherstr,justanotherstr,1,5,0,5,0,0.4,0.107384408
1968220921,offshore_race,offshore_race,1,5,0,5,0,0.3,0.053797164
2812881670,spunkt2,spunkt2,1,1,0,1,0,0,0.010826116
2610309955,Abdzz2012,Abdzz2012,1,5,0,5,0,0.4,0.078020901
347679617,muzahidiftekhar,muzahidiftekhar,1,2,0,2,0,0.5,0.059760868
2776312714,UmmJibraeel,UmmJibraeel,1,2,0,2,0,0.5,0.014596362
2759764932,Shit_witness,Shit_witness,1,1,0,1,0,0,0.010826116
2797939671,AbuKambodee__,AbuKambodee__,1,0,2,2,0,1,0
2473798646,DabiqWarrior,DabiqWarrior,1,1,0,1,0,0,0.010826116
1713482744,AbuAlbaraaSham,AbuAlbaraaSham,1,1,1,2,0,0.5,0.003770246
2748656645,islamisbeauty14,islamisbeauty14,1,1,0,1,0,0,0.010826116
2796137542,UmmKhaled13,UmmKhaled13,1,6,0,6,0,0.36666667,0.102731916
2813504642,Nomad_backup,Nomad_backup,1,1,0,1,0,0,0.010826116
2587176104,observerincog,observerincog,1,5,0,5,0,0.45,0.100950794
2788699385,abdelwalled,abdelwalled,1,1,0,1,0,0,0.004028086
2829331719,steven92863627,steven92863627,1,3,0,3,0,0.5,0.063531114
2797504415,Cop_Killa1924,Cop_Killa1924,1,3,2,5,0,0.5,0.093152461
436940232,atikanwar,atikanwar,1,1,0,1,0,0,0.010826116
2725785044,abirh1971,abirh1971,1,7,0,7,0,0.3809524,0.136123509
2182885967,LiDawud,LiDawud,1,2,0,2,0,1,0.007798333
1098558980,mfabdulhaq,mfabdulhaq,1,3,0,3,0,0.5,0.063531114
2592124425,SyedSeekingIlm,SyedSeekingIlm,1,2,0,2,0,1,0.014854202
323247362,kasepputih,kasepputih,1,1,0,1,0,0,0.010826116
2794008116,elitemilitaria,elitemilitaria,1,1,0,1,0,0,0.004028086
2546249283,strangerm16,strangerm16,1,0,2,2,0,0.5,0
2767957666,dawahtauheed,dawahtauheed,1,1,0,1,0,0,0.010826116
2472817267,zozozolo,zozozolo,1,7,1,8,0,0.4047619,0.122321342
1424305874,dubainiqqa,dubainiqqa,1,6,0,6,0,0.36666667,0.102731916
1482764072,TomWyke,TomWyke,1,2,0,2,0,0.5,0.014596362
188821336,DannyWalto,DannyWalto,1,1,0,1,0,0,0.010826116
2831429465,HarpiyetAlKurdi,HarpiyetAlKurdi,1,3,0,3,0,0.16666667,0.068928724
2569837891,Nemisses87,Nemisses87,1,1,0,1,0,0,0.010826116
2852794302,AjiMukrijal,AjiMukrijal,1,3,0,3,0,0.5,0.093152461
783134678,IjazD,IjazD,1,5,0,5,0,0.4,0.084901662
2485104602,aschinis89,aschinis89,1,1,0,1,0,0,0.010826116
2716512269,bint_hijratain,bint_hijratain,1,3,0,3,0,0.5,0.063788954
206909458,SheWhoMakesItTh,SheWhoMakesItTh,1,1,0,1,0,0,0.010826116
1322463252,IslamZimbabwe,IslamZimbabwe,1,2,1,3,0,0.5,0.059760868
2770907214,IamNotShia,IamNotShia,1,1,0,1,0,0,0.010826116
376221826,sholehkawi,sholehkawi,1,3,0,3,0,0.16666667,0.039307377
2758553736,GaRednecks,GaRednecks,1,1,0,1,0,0,0.010826116
2809540836,abudujana201413,abudujana201413,1,3,0,3,0,0.5,0.063531114
2810622287,__NUL__,__NUL__,1,1,0,1,0,0,0.010826116
2827006337,birdofgreen,birdofgreen,1,2,0,2,0,0.5,0.059760868
1271673235,HassanNimo,HassanNimo,1,1,0,1,0,0,0.010826116
1048649114,abo_musab11,abo_musab11,1,0,1,1,0,0,0
2796597748,ShaheedSwag,ShaheedSwag,1,2,1,3,0,0.5,0.014596362
2550078900,HanzalaGhuraba,HanzalaGhuraba,1,2,3,5,0,0.5,0.059760868
2269885007,mominamatullah,mominamatullah,1,1,0,1,0,0,0.004028086
946877060,AlphaCetiaw,AlphaCetiaw,1,3,0,3,0,0.16666667,0.039307377
2197577153,AlternateAngle9,AlternateAngle9,1,8,1,9,0,0.44642857,0.19329699
2798269099,khilafahi,khilafahi,1,3,0,3,0,0.5,0.063531114
1863660282,_7aa7_,_7aa7_,1,5,0,5,0,0.35,0.098703829
2794763015,AbuDujana___,AbuDujana___,1,0,3,3,0,0.33333334,0
2663002897,sykaleem786,sykaleem786,1,1,0,1,0,0,0.010826116
943371032,ec_mz01,ec_mz01,1,5,0,5,0,0.45,0.100950794
2604774224,AbuBATAATAAA,AbuBATAATAAA,1,4,0,4,0,0.41666666,0.090124678
476787542,sheikhbfour,sheikhbfour,1,6,0,6,0,0.4,0.111412494
2284565358,asadullah021,asadullah021,1,4,0,4,0,0.25,0.042971048
809115114,AshAgony,AshAgony,1,5,0,5,0,0.45,0.092270215
2784408450,araifzahid,araifzahid,1,1,0,1,0,0,0.010826116
386642862,maria_filipova,maria_filipova,1,1,0,1,0,0,0.010826116
2679714750,Zakiyahwafa,Zakiyahwafa,1,2,0,2,0,0.5,0.059760868
2800956407,abu_dharda34,abu_dharda34,1,3,2,5,0,0.5833333,0.056733084
2843128873,ch0zenOne,ch0zenOne,1,1,0,1,0,0,0.010826116
1037775996,yzench,yzench,1,1,0,1,0,0,0.010826116
558118066,DillyHussain88,DillyHussain88,1,1,0,1,0,0,0.010826116
2786964669,JihadNews13,JihadNews13,1,2,4,6,0,0.41666666,0.035537131
57914577,ShamiWitness,ShamiWitness,1,0,4,4,0,0.5833333,0
2796683578,LionessMikasa,LionessMikasa,1,2,0,2,0,0.5,0.059760868
2737288442,AbuAmmaar4,AbuAmmaar4,1,5,1,6,0,0.45,0.100950794
1205220223,moomin1994,moomin1994,1,1,0,1,0,0,0.010826116
355513719,meepkittyfuck,meepkittyfuck,1,1,0,1,0,0,0.010826116
2380248578,Pearl_of_islam1,Pearl_of_islam1,1,3,0,3,0,0.5,0.063531114
2796926540,YasIsAwesome,YasIsAwesome,1,1,0,1,0,0,0.010826116
53130902,gcore22,gcore22,1,1,0,1,0,0,0.010826116
2852271780,Taawhidul,Taawhidul,1,4,0,4,0,0.5,0.117863476
2273261239,muniraali14,muniraali14,1,1,0,1,0,0,0.010826116
2795681483,aliyeeta91,aliyeeta91,1,2,0,2,0,0.5,0.059760868
2820093683,AbuKopjes,AbuKopjes,1,1,0,1,0,0,0.004028086
219395884,hruodwolf,hruodwolf,1,2,0,2,0,0,0.035537131
2781886307,adzaidz,adzaidz,1,1,0,1,0,0,0.010826116
1837610868,RifistanAk47rif,RifistanAk47rif,1,2,0,2,0,0.5,0.059760868
1088436109,WatcherObserver,WatcherObserver,1,5,1,6,0,0.35,0.098703829
342243228,maate_zzz,maate_zzz,1,4,0,4,0,0.5833333,0.0675592
1246509054,AhmadMir11,AhmadMir11,1,1,0,1,0,0,0.010826116
2806462481,AbuMahdi_,AbuMahdi_,1,1,0,1,0,0,0.010826116
26753056,Dizmond,Dizmond,1,1,0,1,0,0,0.010826116
2579773511,e4280391398940e,e4280391398940e,1,3,0,3,0,0.33333334,0.070222568
2779756644,i__SlN,i__SlN,1,2,0,2,0,0.5,0.014596362
1080375468,ryolwh,ryolwh,1,1,0,1,0,0,0.010826116
2795583690,Abu_swaaliha,Abu_swaaliha,1,2,0,2,0,0.5,0.059760868
187676879,jannahbreeze,jannahbreeze,1,1,0,1,0,0,0.010826116
2793650421,lonewolf99army,lonewolf99army,1,2,1,3,0,0.5,0.014596362
2739517694,VeriteSVP,VeriteSVP,1,3,0,3,0,0.8333333,0.018624449
2823797046,RayGunifiedAUS,RayGunifiedAUS,1,4,0,4,0,0.41666666,0.096922707
2835429747,shah1d_1,shah1d_1,1,4,0,4,0,0.5833333,0.0675592
2772416897,khattab_rt_,khattab_rt_,1,4,5,9,0,0.56666666,0.117499061
2807609733,Amaatullah_,Amaatullah_,1,4,0,4,0,0.5833333,0.0675592
629258665,MyWaistSmall,MyWaistSmall,1,5,1,6,0,0.4,0.117934652
35994040,Ajaz707,Ajaz707,1,3,1,4,0,0.33333334,0.094510429
2787850728,CodeofSilence_,CodeofSilence_,1,2,0,2,0,1,0.014854202
2805938675,AbuMusabAlTurki,AbuMusabAlTurki,1,5,1,6,0,0.45,0.092270215
168966659,thuththu,thuththu,1,1,0,1,0,0,0.010826116
1944959562,Fares_alAfghani,Fares_alAfghani,1,2,0,2,0,0.5,0.014596362
2790570579,ISFanBoy999,ISFanBoy999,1,3,0,3,0,0.16666667,0.047987956
2300361306,BeautSinners_,BeautSinners_,1,4,1,5,0,0.5,0.103614162
1351629409,FoAllah_,FoAllah_,1,1,0,1,0,0,0.010826116
2718528614,7aaqdtruth,7aaqdtruth,1,1,0,1,0,0,0.010826116
2433530509,Kinalmal,Kinalmal,1,2,0,2,0,0,0.035537131
2837658384,abuaman_,abuaman_,1,3,0,3,0,0.8333333,0.018624449
2299312960,NewsNerve,NewsNerve,1,2,0,2,0,0.5,0.059760868
856538006,adn444n,adn444n,1,1,0,1,0,0,0.010826116
488750031,tamhussein,tamhussein,1,8,4,12,0,0.44642857,0.186498961
1877326963,Seeking4Good243,Seeking4Good243,1,3,1,4,0,0.5,0.093152461
2838412417,john52747454,john52747454,1,3,0,3,0,0.5,0.056733084
2812558495,courtlee44,courtlee44,1,4,0,4,0,0.41666666,0.052016042
2564322505,ashakir108,ashakir108,1,1,0,1,0,0,0.010826116
2609462570,justkewrious,justkewrious,1,5,0,5,0,0.4,0.100586378
297450801,MindvisionMedia,MindvisionMedia,1,3,0,3,0,0.5,0.084471882
239746434,mokie000,mokie000,1,8,0,8,0,0.4107143,0.186416229
2760621472,AbuHamdaan1,AbuHamdaan1,1,5,0,5,0,0.4,0.101033526
295386583,satrulsis,satrulsis,1,2,0,2,0,0.5,0.014596362
2832612856,waruroze,waruroze,1,1,0,1,0,0,0.010826116
291126889,LimiGura,LimiGura,1,3,0,3,0,0.33333334,0.05467941
2821733995,tawhednasheed,tawhednasheed,1,2,0,2,0,0.5,0.014596362
80526993,abuabdinur,abuabdinur,1,4,1,5,0,0.45,0.0675592
752729762,mufeeee,mufeeee,1,2,0,2,0,0.5,0.014596362
2575810213,rizafa850,rizafa850,1,2,0,2,0,0.5,0.059760868
2748366541,abuyusuf1978,abuyusuf1978,1,1,0,1,0,0,0.010826116
1498037983,lombardo_yercyn,lombardo_yercyn,1,1,0,1,0,0,0.010826116
341458690,martienssen,martienssen,1,1,0,1,0,0,0.010826116
108969810,No2Coconuts,No2Coconuts,1,5,1,6,0,0.35,0.098703829
2574892938,JahanzebSiddiqy,JahanzebSiddiqy,1,1,0,1,0,0,0.010826116
2837200781,Ameer44555,Ameer44555,1,2,0,2,0,0.5,0.014596362
119324602,abu_khalid94,abu_khalid94,1,5,1,6,0,0.56666666,0.128325176
2808692674,dujanaaljanabi,dujanaaljanabi,1,4,0,4,0,0.5833333,0.0675592
2816065509,Alrawy_Almhb,Alrawy_Almhb,1,1,0,1,0,0,0.004028086
2800074730,SwalahSalim,SwalahSalim,1,3,0,3,0,0.16666667,0.063424539
2597896174,AhmedHafio,AhmedHafio,1,4,0,4,0,0.33333334,0.073992814
2783920168,AhomzMohaa,AhomzMohaa,1,2,0,2,0,0,0.044217709
297967623,nikanen,nikanen,1,1,0,1,0,0,0.010826116
246235206,haysamon,haysamon,1,2,0,2,0,0,0.035537131
2790965328,Ukhti_Issa,Ukhti_Issa,1,6,0,6,0,0.4,0.125661808
2770813051,gffggrfg,gffggrfg,1,1,0,1,0,0,0.010826116
76955790,Mausool,Mausool,1,1,0,1,0,0,0.010826116
2230534314,Abu_ilyaas91,Abu_ilyaas91,1,1,0,1,0,0,0.010826116
525222097,SameehEmir,SameehEmir,1,1,0,1,0,0,0.010826116
2752626905,harrycarter87,harrycarter87,1,1,0,1,0,0,0.010826116
2718613876,MetaeNesrulah,MetaeNesrulah,1,1,0,1,0,0,0.010826116
2526298497,rabiuli12706578,rabiuli12706578,1,2,0,2,0,0.5,0.014596362
2769109431,umair_awais,umair_awais,1,1,0,1,0,0,0.010826116
1499840990,BintKitten21,BintKitten21,1,3,0,3,0,0.5,0.063531114
2738504165,oogaali,oogaali,1,3,0,3,0,0.16666667,0.047987956
1643203332,bint_ummah,bint_ummah,1,2,0,2,0,0,0.044217709
149209663,habeebc,habeebc,1,1,0,1,0,0,0.010826116
2611233370,wahiid15,wahiid15,1,2,0,2,0,0.5,0.059760868
1173176964,MuslimAmriki,MuslimAmriki,1,2,0,2,0,0,0.021287817
2773664399,Murabiteen,Murabiteen,1,1,1,2,0,0,0.010826116
2795582920,TheLightTrilogy,TheLightTrilogy,1,0,1,1,0,0,0
2731098921,nadeeraeemaan,nadeeraeemaan,1,1,0,1,0,0,0.010826116
1266598700,hadochi2013,hadochi2013,1,0,3,3,0,0.16666667,0
67814286,helpgazanow2014,helpgazanow2014,1,1,0,1,0,0,0.010826116
66110371,Brotherwahidi,Brotherwahidi,1,1,0,1,0,0,0.010826116
2767143850,8b6b1203c6c348a,8b6b1203c6c348a,1,2,0,2,0,0,0.035537131
852542442,K19_84,K19_84,1,2,0,2,0,0.5,0.014596362
395789389,Xuccaii,Xuccaii,1,2,0,2,0,1,0.014854202
341394533,Knightinveil,Knightinveil,1,1,0,1,0,0,0.010826116
2471740528,weatherexpert24,weatherexpert24,1,1,0,1,0,0,0.010826116
1043303287,asadk08,asadk08,1,2,0,2,0,0.5,0.014596362
2497430757,Abuizzadeen1924,Abuizzadeen1924,1,0,2,2,0,0,0
2831664436,mhadam2014,mhadam2014,1,2,0,2,0,0.5,0.059760868
106022200,qondahar,qondahar,1,3,1,4,0,0.5,0.063531114
1630487928,a_aflal,a_aflal,1,4,0,4,0,0.5833333,0.0675592
782353861,mamluti_10,mamluti_10,1,2,0,2,0,0,0.052962838
2425341397,AbuDujanah0104,AbuDujanah0104,1,1,1,2,0,0,0.010826116
1543030236,AbuAssadullah1,AbuAssadullah1,1,4,1,5,0,0.5,0.117863476
328484318,denuxer,denuxer,1,2,0,2,0,0.5,0.059760868
2150614512,mdtabrezali12,mdtabrezali12,1,5,0,5,0,0.45,0.092270215
2806171133,Abu_Zubay,Abu_Zubay,1,1,0,1,0,0,0.004028086
2557429273,siixzn,siixzn,1,3,0,3,0,0.5,0.063531114
2769471017,Mina29062014,Mina29062014,1,1,0,1,0,0,0.010826116
2786084405,imen_islam,imen_islam,1,1,0,1,0,0,0.010826116
2850080370,mootubighaizikm,mootubighaizikm,1,1,0,1,0,0,0.010826116
2797848256,MuwahidahMbs,MuwahidahMbs,1,1,0,1,0,0,0.010826116
2794407669,Abu_Butayn,Abu_Butayn,1,1,0,1,0,0,0.010826116
2671429472,Ansar4_IS,Ansar4_IS,1,3,0,3,0,0.16666667,0.047987956
2741880708,ktaab84,ktaab84,1,1,1,2,0,0,0.010826116
347850640,irfankhan6160,irfankhan6160,1,3,0,3,0,0.16666667,0.039307377
1006155421,Nagnostic,Nagnostic,1,2,0,2,0,0.5,0.059760868
2339751867,AbuUmaymah2,AbuUmaymah2,1,1,0,1,0,0,0.010826116
2663172165,shahid_assomali,shahid_assomali,1,2,0,2,0,0,0.021287817
2659207273,JGhuraba,JGhuraba,1,4,0,4,0,0.5,0.134764602
2742765729,AbuMary33366869,AbuMary33366869,1,2,0,2,0,1,0.007798333
249280201,maradonka,maradonka,1,2,0,2,0,0.5,0.014596362
2777041100,Muslimi_Kanad,Muslimi_Kanad,1,2,0,2,0,0,0.014489787
179620049,TalkLeftLive,TalkLeftLive,1,4,0,4,0,0.41666666,0.088242128
2765736148,CycloonCyclooon,CycloonCyclooon,1,4,0,4,0,0.41666666,0.096816132
2302363882,aquasurf1,aquasurf1,1,4,0,4,0,0.5833333,0.0675592
837595712,khalid7430,khalid7430,1,1,0,1,0,0,0.010826116
171395419,midhu967,midhu967,1,1,0,1,0,0,0.010826116
2796013985,AsawirtiMedia0O,AsawirtiMedia0O,1,0,1,1,0,0,0
2259995065,MohamedMadheeh,MohamedMadheeh,1,1,0,1,0,0,0.004028086
2748369363,IbnuTalha,IbnuTalha,1,3,0,3,0,0.5,0.063531114
169429509,mr_hl3ro,mr_hl3ro,1,3,0,3,0,0.5,0.063531114
2722843210,metivisha,metivisha,1,1,0,1,0,0,0.010826116
1594247838,twhdnow,twhdnow,1,2,0,2,0,0.5,0.014596362
2750171827,HanzalaDaily,HanzalaDaily,1,2,0,2,0,0.5,0.059760868
2548058820,mhwisis,mhwisis,1,3,0,3,0,0.33333334,0.05467941
616188654,KucengIreng,KucengIreng,1,2,0,2,0,0.5,0.059760868
2836351759,AbuAustrali,AbuAustrali,1,4,1,5,0,0.41666666,0.094933583
2814987073,abu_obaida1,abu_obaida1,1,1,0,1,0,0,0.010826116
2812431243,abu_75hurs,abu_75hurs,1,4,0,4,0,0.5833333,0.0675592
114046798,noelhefele,noelhefele,1,1,0,1,0,0,0.010826116
335825895,Neevcapricon,Neevcapricon,1,1,0,1,0,0,0.010826116
2447100918,mbzro,mbzro,1,1,1,2,0,0,0.010826116
2691058704,spreadtheseed1,spreadtheseed1,1,4,0,4,0,0.5833333,0.0675592
2799750207,williamsharpe01,williamsharpe01,1,3,0,3,0,0.5,0.056733084
2848935042,pinkbiser77,pinkbiser77,1,1,0,1,0,0,0.010826116
2766457990,atlas0201,atlas0201,1,5,0,5,0,0.4,0.107642248
2819187225,abubakraustrali,abubakraustrali,1,2,0,2,0,0.5,0.059760868
1668697268,GleamingRazor,GleamingRazor,1,1,0,1,0,0,0.010826116
2837236935,abusuleymann,abusuleymann,1,4,0,4,0,0.41666666,0.127966572
98607658,safzath,safzath,1,1,0,1,0,0,0.004028086
970509649,TariqRanaSahib,TariqRanaSahib,1,4,0,4,0,0.41666666,0.088242128
2823081323,JoshPwr,JoshPwr,1,2,0,2,0,0.5,0.059760868
175394179,rexetsacerdos,rexetsacerdos,1,1,0,1,0,0,0.010826116
718294442,ShirazMaher,ShirazMaher,1,7,1,8,0,0.35714287,0.136570656
2572864969,saifalmomineen,saifalmomineen,1,2,2,4,0,0.5,0.059760868
2326679196,princeahmad748,princeahmad748,1,2,0,2,0,0.5,0.014596362
519851712,Nefarious_Acts,Nefarious_Acts,1,7,0,7,0,0.35714287,0.113640764
2810007247,AbouZayd08,AbouZayd08,1,2,0,2,0,0,0.052962838
2863779554,jeddahboy_cfc2,jeddahboy_cfc2,1,1,0,1,0,0,0.004028086
1607356176,HMFeed_ops,HMFeed_ops,1,1,0,1,0,0,0.010826116
2595016494,auleeya_kareem,auleeya_kareem,1,2,0,2,0,0.5,0.014596362
303681341,PerryAlexJ,PerryAlexJ,1,3,0,3,0,0.8333333,0.018624449
571854743,dralgzouli,dralgzouli,1,0,2,2,0,0,0
238909424,hiimfarhiya,hiimfarhiya,1,1,0,1,0,0,0.010826116
2804535232,bavaryb,bavaryb,1,4,0,4,0,0.41666666,0.052016042
2571751510,LeanBen1,LeanBen1,1,2,0,2,0,0.5,0.059760868
2601832549,ismvh,ismvh,1,5,0,5,0,0.4,0.121891562
2796965224,AbuAbdullah526,AbuAbdullah526,1,2,0,2,0,0.5,0.014596362
1038340248,king_fizzo,king_fizzo,1,2,0,2,0,0,0.021287817
390025381,halid_ali,halid_ali,1,1,0,1,0,0,0.010826116
2544193723,MagdalenaPunz,MagdalenaPunz,1,1,0,1,0,0,0.004028086
2568999102,de_BlackRose,de_BlackRose,1,3,2,5,0,0.5,0.093152461
2832519430,NuhaAkhtar,NuhaAkhtar,1,1,0,1,0,0,0.010826116
2788872467,jsnow_01,jsnow_01,1,9,0,9,0,0.4027778,0.197325077
2260318100,ASupercivilian,ASupercivilian,1,1,0,1,0,0,0.010826116
2762887466,IliesWiki,IliesWiki,1,3,0,3,0,0.33333334,0.086354431
2794311981,mrjnamouahida2k,mrjnamouahida2k,1,3,0,3,0,0.8333333,0.018624449
626479444,zaursharif,zaursharif,1,1,0,1,0,0,0.010826116
1631736158,omrxfzn,omrxfzn,1,2,0,2,0,0,0.021287817
2677658017,_abu_dujana_,_abu_dujana_,1,2,0,2,0,0.5,0.014596362
2311901628,eonebennoah,eonebennoah,1,2,0,2,0,0,0.021287817
124670417,Athilcool,Athilcool,1,3,0,3,0,0.33333334,0.047881381
2617070040,abuag2014,abuag2014,1,4,0,4,0,0.33333334,0.073992814
2830062043,UmmUssamah11,UmmUssamah11,1,2,0,2,0,0.5,0.059760868
2791690721,Abu_Rafiq_,Abu_Rafiq_,1,6,0,6,0,0.4,0.111412494
2855916019,abufulaan7,abufulaan7,1,3,0,3,0,0.5,0.056733084
1489981951,abu_mutaz_,abu_mutaz_,1,1,0,1,0,0,0.004028086
2204190377,ummuwais11,ummuwais11,1,4,0,4,0,0.33333334,0.088135553
560321063,bromeomusic,bromeomusic,1,1,0,1,0,0,0.010826116
2664944172,kanadihuda,kanadihuda,1,1,0,1,0,0,0.010826116
2328253005,AbuIbrahimBrit,AbuIbrahimBrit,1,1,3,4,0,0.5,0.033391593
2693124704,AbdulAhadIslam,AbdulAhadIslam,1,2,1,3,0,0.33333334,0.021287817
2583876230,AbuuZubayr,AbuuZubayr,1,3,0,3,0,0.5,0.093152461
2795786943,AlArabi__,AlArabi__,1,2,2,4,0,0.33333334,0.028739101
2818921163,42Aamir,42Aamir,1,1,0,1,0,0,0.004028086
296833740,w1tnesskhilafah,w1tnesskhilafah,1,2,1,3,0,0.5,0.059760868
2827571957,umm_salama_15,umm_salama_15,1,4,0,4,0,0.41666666,0.088242128
205542143,AbuMuhammad_1,AbuMuhammad_1,1,2,0,2,0,0,0.044217709
2177749761,Endanger,Endanger,1,1,0,1,0,0,0.010826116
2827539273,TV_Newsroom,TV_Newsroom,1,1,0,1,0,0,0.010826116
2723468173,bintCAhmed,bintCAhmed,1,3,0,3,0,0.5,0.063531114
2801783727,UkhtyE7,UkhtyE7,1,8,0,8,0,0.44642857,0.186498961
2677789646,SaifOfIslam,SaifOfIslam,1,2,1,3,0,0,0.021287817
2350765032,AbuSeid123,AbuSeid123,1,3,0,3,0,0.5,0.093152461
2782123004,DheenAkmal,DheenAkmal,1,4,0,4,0,0.41666666,0.096922707
2820265018,chechclearrr,chechclearrr,1,6,4,10,0,0.4047619,0.118551096
2505299005,ProMuslim1,ProMuslim1,1,1,1,2,0,1,0.010826116
2744767652,2013gmr2014,2013gmr2014,1,3,0,3,0,0.5,0.056733084
2837931840,ISiOS_3,ISiOS_3,1,2,0,2,0,1,0.007798333
2830062801,khilafah1s1s,khilafah1s1s,1,3,0,3,0,0.5,0.093152461
2822657237,abuumar__,abuumar__,1,1,1,2,0,0,0.010826116
2772194525,Saffa__M,Saffa__M,1,3,0,3,0,0.5,0.093152461
1228756218,AbuUmarAlAlbani,AbuUmarAlAlbani,1,2,0,2,0,0.5,0.059760868
1034409212,Shahid9292,Shahid9292,1,2,0,2,0,0,0.044217709
2743751934,kurniaosop,kurniaosop,1,1,0,1,0,0,0.010826116
2767173849,LemonNigga,LemonNigga,1,1,0,1,0,0,0.010826116
2817152440,Newswatcher25,Newswatcher25,1,1,0,1,0,0,0.010826116
1434080766,lifabu,lifabu,1,2,0,2,0,0,0.044217709
1875465750,Abu_Ibraheem_23,Abu_Ibraheem_23,1,2,0,2,0,0.5,0.059760868
2601014809,joy_florida,joy_florida,1,2,0,2,0,0,0.03741968
2836321857,y__dohak,y__dohak,1,3,1,4,0,0.5,0.063531114
2694960730,ArmyOvJustice,ArmyOvJustice,1,1,0,1,0,0,0.010826116
321771207,1Parkour,1Parkour,1,1,0,1,0,0,0.010826116
2782320395,abumuhameed,abumuhameed,1,5,0,5,0,0.4,0.100586378
2655639390,Omar___1435,Omar___1435,1,3,0,3,0,0.5,0.093152461
51107733,MaSSiLiaMeDia,MaSSiLiaMeDia,1,1,0,1,0,0,0.010826116
2813450154,Junood_ad_dawla,Junood_ad_dawla,1,3,2,5,0,0.5,0.063531114
87250860,smitso_16,smitso_16,1,2,0,2,0,0,0.044217709
165402973,Paki_Jav,Paki_Jav,1,3,0,3,0,0.5,0.063531114
165697534,najmudi,najmudi,1,8,0,8,0,0.4107143,0.186416229
157243487,ArifScorpio,ArifScorpio,1,1,0,1,0,0,0.010826116
2700564583,ZabdalMaarifa,ZabdalMaarifa,1,2,0,2,0,1,0.014854202
2578667634,B_i_Allahut,B_i_Allahut,1,2,0,2,0,0.5,0.014596362
2827704505,IS_Admirer,IS_Admirer,1,3,0,3,0,0.16666667,0.068928724
2391464143,Abu_Yusuf_1,Abu_Yusuf_1,1,1,2,3,0,0.16666667,0.010461701
1480087771,378Hameed,378Hameed,1,4,0,4,0,0.41666666,0.088499969
348969244,Quotes_Yo,Quotes_Yo,1,9,0,9,0,0.4027778,0.197325077
340842911,Islamiat101,Islamiat101,1,2,0,2,0,0.5,0.059760868
101669282,naushad2982,naushad2982,1,2,0,2,0,0.5,0.059760868
2647349677,485033453,485033453,1,1,0,1,0,0,0.010826116
771283422,grozozo2012,grozozo2012,1,2,0,2,0,0,0.044217709
1355110922,shamus1924,shamus1924,1,2,1,3,0,0.33333334,0.021287817
2802342478,Lionsdenamerica,Lionsdenamerica,1,2,0,2,0,0,0.035537131
1679841894,DermotMarrey,DermotMarrey,1,1,0,1,0,0,0.010826116
2845071980,ansaralummah3,ansaralummah3,1,1,1,2,0,0,0.010826116
2237618886,HammamiAbu,HammamiAbu,1,6,0,6,0,0.4,0.088929749
1433230086,Maloof4,Maloof4,1,1,0,1,0,0,0.010826116
2549766922,MUJAHID_20049,MUJAHID_20049,1,2,1,3,0,0.5,0.059760868
376331079,AbuYahya21,AbuYahya21,1,2,2,4,0,0,0.035537131
2717342607,ruqayyah_ru,ruqayyah_ru,1,4,0,4,0,0.16666667,0.089600097
2421575491,Muhammadisa74G,Muhammadisa74G,1,2,0,2,0,0.5,0.014596362
2260425629,AbuTuraab2014,AbuTuraab2014,1,2,1,3,0,0.5,0.059760868
2852215747,strangerguraba,strangerguraba,1,8,0,8,0,0.375,0.147032357
2708364249,Escape2Allah,Escape2Allah,1,4,0,4,0,0.41666666,0.090124678
2765052958,luul_hassan,luul_hassan,1,1,0,1,0,0,0.010826116
2844908611,teduastedua,teduastedua,1,2,0,2,0,0.5,0.059760868
1258413175,StrivingBro,StrivingBro,1,5,1,6,0,0.5,0.128325176
2820562056,MuslimIslam10,MuslimIslam10,1,1,0,1,0,0,0.010826116
388881586,Uxykhan,Uxykhan,1,1,0,1,0,0,0.010826116
2777537827,CruisingBye,CruisingBye,1,1,0,1,0,0,0.010826116
602889531,mohamedazik3,mohamedazik3,1,5,0,5,0,0.45,0.100950794
315710919,shahrulhaidi,shahrulhaidi,1,1,0,1,0,0,0.010826116
2593578464,saleel_sawarim,saleel_sawarim,1,2,0,2,0,0.5,0.059760868
2850381295,Abuoffle,Abuoffle,1,3,0,3,0,0.5,0.063531114
272227937,Candrabuhori,Candrabuhori,1,1,0,1,0,0,0.010826116
227998317,BereketMjde,BereketMjde,1,1,0,1,0,0,0.010826116
2741886636,aburijal001,aburijal001,1,4,0,4,0,0.5833333,0.0675592
331865791,Jerry_R_Martin,Jerry_R_Martin,1,2,0,2,0,0.5,0.059760868
2661310150,tohhMuslimah,tohhMuslimah,1,2,0,2,0,0,0.021287817
536731409,deepakp92130740,deepakp92130740,1,3,0,3,0,0.5,0.063531114
317742910,salahhuddeen,salahhuddeen,1,2,0,2,0,0.5,0.059760868
59858772,Censored31,Censored31,1,0,2,2,0,1,0
2280316467,IzetBin,IzetBin,1,4,0,4,0,0.5,0.103614162
2343985073,AbuAyub_0,AbuAyub_0,1,1,0,1,0,0,0.010826116
1197013686,abu_anas111,abu_anas111,1,1,0,1,0,0,0.010826116
61628514,iThinkin,iThinkin,1,2,0,2,0,0.5,0.014596362
2795855987,Muharibah,Muharibah,1,2,0,2,0,1,0.007798333
106029201,kausarazmi,kausarazmi,1,5,0,5,0,0.4,0.121633722
2834522284,abuabbasluqman,abuabbasluqman,1,1,0,1,0,0,0.010826116
1399546038,Bint_El_3rwa,Bint_El_3rwa,1,3,0,3,0,0.16666667,0.047987956
2577916138,ISIS_Kashmir786,ISIS_Kashmir786,1,4,0,4,0,0.41666666,0.081444099
355459324,HambaDia,HambaDia,1,4,0,4,0,0.5,0.103614162
90398976,cufuk,cufuk,1,1,0,1,0,0,0.010826116
2835472689,_hud_hud_,_hud_hud_,1,1,0,1,0,0,0.010826116
2755486062,feeq6,feeq6,1,7,0,7,0,0.3809524,0.136123509
2805555571,sunny_k2014,sunny_k2014,1,2,0,2,0,0.5,0.059760868
2824954246,ZQanbaloo,ZQanbaloo,1,1,0,1,0,0,0.010826116
1073471940,Saja5045,Saja5045,1,4,0,4,0,0.41666666,0.096922707
2564383220,Inner_Anarchy,Inner_Anarchy,1,2,0,2,0,0,0.035537131
2714325080,islambok1,islambok1,1,5,0,5,0,0.4,0.121633722
29680147,colanicea,colanicea,1,1,0,1,0,0,0.010826116
2831278617,BritaniQaqa,BritaniQaqa,1,0,1,1,0,0,0
2820825687,Alkhalifa775,Alkhalifa775,1,2,0,2,0,0.5,0.059760868
299557473,alyiance,alyiance,1,3,0,3,0,0.5,0.056733084
2406048373,g3nn1e,g3nn1e,1,3,2,5,0,0.33333334,0.05467941
391471763,murad4441,murad4441,1,5,0,5,0,0.45,0.092270215
2827936408,hamza_frankfurt,hamza_frankfurt,1,1,0,1,0,0,0.010826116
2798445279,ummuukais,ummuukais,1,2,0,2,0,0,0.052962838
2835931898,HelpMe7813,HelpMe7813,1,1,0,1,0,0,0.010826116
2799493919,abubakr1492,abubakr1492,1,9,2,11,0,0.4027778,0.197325077
2851070785,ibnabdullah1932,ibnabdullah1932,1,2,0,2,0,0.5,0.059760868
869393226,chicagoraju,chicagoraju,1,1,0,1,0,0,0.010826116
2829607787,JustsPreeing,JustsPreeing,1,4,0,4,0,0.5833333,0.0675592
2733794174,UmmSafiyyaah,UmmSafiyyaah,1,3,0,3,0,0.5,0.063788954
2614059911,Abu_BlackBerry,Abu_BlackBerry,1,3,0,3,0,0.16666667,0.025058063
203973512,princess_meena,princess_meena,1,1,0,1,0,0,0.010826116
429319081,MehrAdeeb,MehrAdeeb,1,2,0,2,0,0.5,0.059760868
478503877,endeagle1,endeagle1,1,2,0,2,0,0,0.052962838
1630430173,jihadforkhilafa,jihadforkhilafa,1,2,0,2,0,0.5,0.059760868
2301748354,antiwarp,antiwarp,1,2,0,2,0,0,0.044217709
2717770941,IrMaleek,IrMaleek,1,3,0,3,0,0.16666667,0.039307377
2792842433,IsqHunter,IsqHunter,1,5,0,5,0,0.45,0.092270215
2793825477,thebaseddrone,thebaseddrone,1,3,0,3,0,0.5,0.056733084
998204676,mmfzopbhradio1,mmfzopbhradio1,1,3,0,3,0,0.16666667,0.025058063
2185979204,CitiChattr,CitiChattr,1,2,0,2,0,0,0.021287817
2422695287,suheib_,suheib_,1,3,2,5,0,0.5,0.063531114
2792482219,MivesMeeheh,MivesMeeheh,1,1,0,1,0,0,0.004028086
231400912,tjstifler,tjstifler,1,5,0,5,0,0.4,0.107384408
2784028274,s_qaasem,s_qaasem,1,2,0,2,0,1,0.007798333
2785535653,tquran16,tquran16,1,2,0,2,0,0,0.035537131
2793793304,JamilaLou_,JamilaLou_,1,1,0,1,0,0,0.010826116
2808964928,umarislam42,umarislam42,1,5,0,5,0,0.4,0.084901662
2568677239,chiloh88,chiloh88,1,4,0,4,0,0.41666666,0.097180547
2651350908,Zenith114,Zenith114,1,1,0,1,0,0,0.010826116
2773444585,jani4500,jani4500,1,2,0,2,0,0.5,0.014596362
2740054094,Ahamedfathhhh,Ahamedfathhhh,1,5,0,5,0,0.4,0.121633722
2827282576,AbuOwl,AbuOwl,1,4,0,4,0,0.5833333,0.0675592
1707146264,Abu_Hafs_,Abu_Hafs_,1,3,0,3,0,0.16666667,0.047987956
89909474,nazvedder,nazvedder,1,1,0,1,0,0,0.010826116
2723375383,mrsmaherzain,mrsmaherzain,1,2,0,2,0,0.5,0.059760868
2510580016,HassanBahara,HassanBahara,1,2,0,2,0,0,0.021287817
2849597827,sniper_view,sniper_view,1,1,0,1,0,0,0.010826116
75327890,AndreenaNarayan,AndreenaNarayan,1,1,0,1,0,0,0.010826116
554953225,afalpichen,afalpichen,1,1,0,1,0,0,0.010826116
2817321526,AbuHaleema01,AbuHaleema01,1,1,1,2,0,0,0.010826116
2513135384,omarumair1122,omarumair1122,1,1,0,1,0,0,0.010826116
2322852517,abu3antarr,abu3antarr,1,0,2,2,0,0.5,0
915728172,SayfulIslam101,SayfulIslam101,1,1,0,1,0,0,0.010826116
492399378,RobertSerenka,RobertSerenka,1,1,0,1,0,0,0.010826116
2794515265,DawlatulJihad,DawlatulJihad,1,3,0,3,0,0.5,0.056733084
437578598,AliNisarAhmed,AliNisarAhmed,1,5,0,5,0,0.4,0.138534848
134114177,humayunghani,humayunghani,1,1,0,1,0,0,0.010826116
541879261,iszade1,iszade1,1,5,0,5,0,0.55,0.11452301
2792385509,abukaayz,abukaayz,1,5,0,5,0,0.4,0.100586378
2680253494,UmmatMohamd,UmmatMohamd,1,2,0,2,0,0.5,0.059760868
2795891779,bintsabr,bintsabr,1,2,0,2,0,0.5,0.014596362
486632518,esperanza543,esperanza543,1,4,0,4,0,0.33333334,0.079390425
2816928844,OmarRahim7,OmarRahim7,1,7,0,7,0,0.4047619,0.143004271
2771119192,angrycat007,angrycat007,1,2,1,3,0,1,0.007798333
2680941662,blackflag187,blackflag187,1,3,0,3,0,0.16666667,0.025058063
452962153,Abdillah_abu,Abdillah_abu,1,3,1,4,0,0.33333334,0.025058063
555576474,Blertoni10,Blertoni10,1,1,0,1,0,0,0.010826116
2790747292,braz_ISIS,braz_ISIS,1,1,0,1,0,0,0.010826116
2731109596,NatiNawal,NatiNawal,1,1,0,1,0,0,0.010826116
2568449280,IbnAsSabeel,IbnAsSabeel,1,3,1,4,0,0.5,0.055126557
2772135180,jafaralmalawi,jafaralmalawi,1,8,0,8,0,0.42857143,0.172614062
2818600236,131313catchme,131313catchme,1,4,0,4,0,0.41666666,0.096816132
2580999470,ChyukaRyori1,ChyukaRyori1,1,1,1,2,0,0,0.004028086
417099083,kashmiriee,kashmiriee,1,1,1,2,0,0,0.010826116
2803166566,RadioR_m,RadioR_m,1,6,0,6,0,0.4,0.125661808
1157262715,bride_traveller,bride_traveller,1,3,0,3,0,0.16666667,0.039307377
20540813,EdRose75,EdRose75,1,1,0,1,0,0,0.010826116
2626605647,AbuKhalidAK,AbuKhalidAK,1,1,2,3,0,0.5,0.048934752
2685201942,Mahz4130,Mahz4130,1,2,0,2,0,0.5,0.014596362
2739793439,SudaniAbu,SudaniAbu,1,2,1,3,0,0.8333333,0.014596362
44822063,M3diantara,M3diantara,1,2,0,2,0,0.5,0.059760868
2793467481,ISOiOS_2,ISOiOS_2,1,3,0,3,0,0.8333333,0.018624449
2828136034,AbuAmeenah2014,AbuAmeenah2014,1,3,0,3,0,0.5,0.063531114
56716934,epicloser,epicloser,1,4,1,5,0,0.45,0.088242128
162459363,MikeDugent,MikeDugent,1,1,0,1,0,0,0.010826116
2385407731,MaliWitness,MaliWitness,1,2,6,8,0,0.52380955,0.06075442
244215577,Truthhurts_alie,Truthhurts_alie,1,3,0,3,0,0.33333334,0.05467941
2783080233,DaaifulMansoora,DaaifulMansoora,1,7,1,8,0,0.3809524,0.136123509
850030392,RiceAah,RiceAah,1,5,0,5,0,0.4,0.107384408
873099116,DeganAli,DeganAli,1,4,0,4,0,0.41666666,0.107025804
2821156720,WordsWeapons,WordsWeapons,1,1,0,1,0,0,0.010826116
2587258794,JanJans07770664,JanJans07770664,1,1,0,1,0,0,0.010826116
2579328973,kc_medic,kc_medic,1,4,0,4,0,0.33333334,0.073992814
2606297063,ahsab19,ahsab19,1,1,0,1,0,0,0.004028086
2797465661,ProtocolJihad1,ProtocolJihad1,1,3,1,4,0,0.5,0.063531114
2252435669,abd135246,abd135246,1,2,0,2,0,0.5,0.014596362
2804674793,soufexp,soufexp,1,1,0,1,0,0,0.010826116
30699754,rcallimachi,rcallimachi,1,5,1,6,0,0.43333334,0.100950794
2814308678,AbuHudzayfa,AbuHudzayfa,1,4,0,4,0,0.41666666,0.096922707
2827153748,windcrescent,windcrescent,1,2,0,2,0,0.5,0.014596362
2807263588,salman_ghuraba,salman_ghuraba,1,5,0,5,0,0.3,0.076727057
1455543019,Mustafa40866253,Mustafa40866253,1,2,0,2,0,0.5,0.059760868
492958089,d4nielrazak,d4nielrazak,1,3,0,3,0,0.16666667,0.064889082
531493259,rikaz_sumal,rikaz_sumal,1,4,2,6,0,0.5833333,0.0675592
2817454487,muragham77,muragham77,1,3,0,3,0,0.5,0.063788954
2698179007,JundReporter1,JundReporter1,1,0,3,3,0,0.33333334,0
233992645,BloodyhellBarb,BloodyhellBarb,1,5,0,5,0,0.45,0.092270215
2761552364,nuhasomaal,nuhasomaal,1,2,0,2,0,0,0.044217709
2552984221,OneGreenPearl,OneGreenPearl,1,3,0,3,0,0.5,0.056733084
327283372,rezantoran,rezantoran,1,7,0,7,0,0.35714287,0.136570656
2829808319,sj73164,sj73164,1,1,0,1,0,0,0.010826116
821700726,AAhronheim,AAhronheim,1,1,0,1,0,0,0.010826116
2846159582,News_Khilafah,News_Khilafah,1,0,2,2,0,1,0
20837129,dhivehistan,dhivehistan,1,5,0,5,0,0.4,0.121633722
2606920591,yahyaahamed90,yahyaahamed90,1,1,0,1,0,0,0.010826116
2607379358,boudjam3a,boudjam3a,1,1,0,1,0,0,0.010826116
2809721765,striving4sharia,striving4sharia,1,3,0,3,0,0.5,0.084471882
2685531085,salimothman4,salimothman4,1,0,1,1,0,0,0
2675471334,al_amriiki,al_amriiki,1,1,0,1,0,0,0.004028086
2727998440,gorawiy,gorawiy,1,1,0,1,0,0,0.010826116
2827613164,Love4Khilafah,Love4Khilafah,1,3,0,3,0,0.16666667,0.039307377
2290119846,IS_0rdu,IS_0rdu,1,4,1,5,0,0.4,0.058449656
608924880,crazymandocs,crazymandocs,1,1,0,1,0,0,0.010826116
2849174756,abudujana660,abudujana660,1,2,0,2,0,0.5,0.059760868
2801431846,khattab_ibn,khattab_ibn,1,4,0,4,0,0.16666667,0.07269897
183334236,AmarAmarasingam,AmarAmarasingam,1,4,0,4,0,0.41666666,0.081444099
2773972371,aldetroiti,aldetroiti,1,1,0,1,0,0,0.010826116
1417180634,Best_Way_57,Best_Way_57,1,1,0,1,0,0,0.010826116
885224954,FeministTears,FeministTears,1,1,0,1,0,0,0.010826116
2568386046,AbuMuhsin1435,AbuMuhsin1435,1,3,0,3,0,0.33333334,0.070222568
2452977188,shalew1212,shalew1212,1,1,0,1,0,0,0.004028086
2511042195,ShannonGlynnx,ShannonGlynnx,1,1,0,1,0,0,0.010826116
1467446959,CzarMohammad,CzarMohammad,1,1,0,1,0,0,0.010826116
2600826565,MujahidShaheed,MujahidShaheed,1,1,0,1,0,0,0.010826116
86734563,pimedianews,pimedianews,1,3,1,4,0,0.16666667,0.025058063
979892004,Umhidayaa,Umhidayaa,1,1,0,1,0,0,0.010826116
2822731654,abukittykat,abukittykat,1,4,0,4,0,0.41666666,0.088242128
2230024166,AbouZedjef,AbouZedjef,1,4,0,4,0,0.33333334,0.073992814
177076208,dakbanamo,dakbanamo,1,1,0,1,0,0,0.010826116
2173925381,PromiseOfAllah,PromiseOfAllah,1,2,0,2,0,0.5,0.059760868
151353422,ondrejhatas,ondrejhatas,1,1,0,1,0,0,0.010826116
2655516824,zhayyeed,zhayyeed,1,1,0,1,0,0,0.010826116
1296955580,aamushary,aamushary,1,1,0,1,0,0,0.010826116
2567469356,sanee_san,sanee_san,1,1,0,1,0,0,0.010826116
1706686766,wahyu44084014,wahyu44084014,1,1,0,1,0,0,0.004028086
2606528929,talha_pak,talha_pak,1,5,0,5,0,0.4,0.121633722
2611935657,AbuMusliim,AbuMusliim,1,3,2,5,0,0.33333334,0.070222568
2678225342,Bu_mumin,Bu_mumin,1,1,0,1,0,0,0.004028086
2822371804,lafleur8q,lafleur8q,1,2,0,2,0,0.5,0.014596362
2805889528,Raging_lioness,Raging_lioness,1,3,0,3,0,0.33333334,0.077673853
2797884503,AiimAtif,AiimAtif,1,2,0,2,0,0,0.035537131
2734291481,WolfieSmith5,WolfieSmith5,1,2,0,2,0,0.5,0.014596362
2719644255,ferozeahmedboda,ferozeahmedboda,1,2,0,2,0,0.5,0.059760868
2350119533,JihadHayaty,JihadHayaty,1,5,0,5,0,0.4,0.107384408
2583788143,UmmSaeef,UmmSaeef,1,5,1,6,0,0.4,0.078020901
2647325331,abuadamix14,abuadamix14,1,3,0,3,0,0.5,0.093152461
549616306,Islami_pics,Islami_pics,1,4,1,5,0,0.33333334,0.036224751
632296574,HaroonNathie,HaroonNathie,1,1,0,1,0,0,0.010826116
1586953038,muhajir_1,muhajir_1,1,0,3,3,0,0.5,0
1549597706,Ali_Anonymous1,Ali_Anonymous1,1,1,0,1,0,0,0.010826116
1072922461,NYyankeeSteve45,NYyankeeSteve45,1,6,0,6,0,0.4,0.132095423
2834070606,aiesha_jawaid,aiesha_jawaid,1,3,0,3,0,0.33333334,0.041189926
2677242969,dodo1924d,dodo1924d,1,1,0,1,0,0,0.010826116
1346534514,StorerGavin,StorerGavin,1,1,0,1,0,0,0.010826116
15400294,azelin,azelin,1,0,7,7,0,0.35714287,0
707394925,findthetruth0,findthetruth0,1,8,0,8,0,0.375,0.147032357
18601193,SBINS_,SBINS_,1,1,0,1,0,0,0.010826116
2721512996,aminahhussein,aminahhussein,1,3,1,4,0,0.5,0.063531114
2522840637,Alfurqan786,Alfurqan786,1,2,0,2,0,0,0.021287817
2739699278,jihadi4life,jihadi4life,1,2,0,2,0,0.5,0.059760868
2823061264,sheikh8825,sheikh8825,1,2,0,2,0,0.5,0.059760868
2801696543,Betfair444,Betfair444,1,1,0,1,0,0,0.010826116
2824601414,__Me_Is__,__Me_Is__,1,1,0,1,0,0,0.010826116
2499477361,hinderjoddha,hinderjoddha,1,4,0,4,0,0.33333334,0.072592395
753991542,Saima1306,Saima1306,1,1,0,1,0,0,0.010826116
2843672508,razialvi1011,razialvi1011,1,1,0,1,0,0,0.010826116
435202729,mnlkpo0912,mnlkpo0912,1,5,0,5,0,0.4,0.100586378
300777532,flyndre_nemesis,flyndre_nemesis,1,1,0,1,5,0,0.033391593
2805137476,Abuu_Rayan,Abuu_Rayan,1,0,2,2,5,0.5,0
1013973096,nurainea,nurainea,1,2,1,3,5,1,0.082326345
2785804416,lunfullo,lunfullo,1,2,0,2,5,1,0.082326345
2752151753,luqmaan0304,luqmaan0304,1,1,0,1,5,0,0.033391593
2316959965,Khan86Y,Khan86Y,1,2,0,2,5,1,0.043853294
964460767,ibby090,ibby090,1,1,0,1,5,0,0.033391593
2288615661,Mytoplip,Mytoplip,1,2,0,2,5,1,0.082326345
2856091902,muneerahmad4792,muneerahmad4792,1,2,0,2,5,1,0.082326345
1471480159,serdarzh,serdarzh,1,1,0,1,5,0,0.033391593
2402877831,SlafeeI,SlafeeI,1,1,0,1,5,0,0.033391593
2566259094,akhihamouda1,akhihamouda1,1,1,0,1,5,0,0.033391593
449315225,_ThatHijabiMaab,_ThatHijabiMaab,1,1,0,1,5,0,0.033391593
1948063147,jasle69,jasle69,1,2,0,2,5,1,0.082326345
2573074974,UmranMohammad,UmranMohammad,1,3,0,3,5,0.8333333,0.092788046
2810511981,Abdul_Al_Jame_,Abdul_Al_Jame_,1,1,0,1,5,0,0.033391593
2509570688,18Rushi,18Rushi,1,2,0,2,5,1,0.082326345
2666922646,rashashii,rashashii,1,2,0,2,5,1,0.082326345
2766996167,AFdoki,AFdoki,1,1,0,1,5,0,0.033391593
2776302317,abooahmed06,abooahmed06,1,2,0,2,5,1,0.043853294
2449179434,MuhammadSauvlat,MuhammadSauvlat,1,2,0,2,5,1,0.043853294
2240260918,UmmAqsa,UmmAqsa,1,1,1,2,5,0,0.033391593
1470268242,alCanadi1421,alCanadi1421,1,1,1,2,5,0,0.033391593
1459684280,UmmHidaya,UmmHidaya,1,1,0,1,5,0,0.033391593
2713092255,SayyidQutb_,SayyidQutb_,1,2,0,2,5,1,0.082326345
790070214,Akhi_Talib,Akhi_Talib,1,1,0,1,5,0,0.033391593
2293826552,diamant_pr,diamant_pr,1,1,0,1,5,0,0.033391593
1706508458,dawla_is1,dawla_is1,1,1,0,1,5,0,0.033391593
2563965961,Musaykeeno,Musaykeeno,1,1,0,1,5,0,0.033391593
1529054311,RSyrianCivilWar,RSyrianCivilWar,1,1,0,1,5,0,0.033391593
270435440,hridoy126,hridoy126,1,1,0,1,5,0,0.033391593
2368504956,ValmirKelmendi1,ValmirKelmendi1,1,1,0,1,5,0,0.033391593
2602796215,supabro1984,supabro1984,1,2,0,2,5,1,0.082326345
2420016318,ryanmofarrell,ryanmofarrell,1,1,0,1,5,0,0.033391593
2457928897,ZawjatShaheed1,ZawjatShaheed1,1,1,0,1,5,0,0.033391593
356910356,MAsadUllahKhan1,MAsadUllahKhan1,1,1,0,1,5,0,0.033391593
2788590984,ranyaranya19,ranyaranya19,1,1,0,1,5,0,0.033391593
2661615001,abou_shaheed,abou_shaheed,1,2,0,2,5,1,0.082326345
14374475,Abd_Mohamm3d,Abd_Mohamm3d,1,1,0,1,5,0,0.033391593
2317583814,raisashraf7,raisashraf7,1,1,0,1,5,0,0.033391593
1647838687,MGhannamNYT,MGhannamNYT,1,1,0,1,5,0,0.033391593
2677605866,mustabdullah3,mustabdullah3,1,1,0,1,5,0,0.033391593
2482013678,_AbuAbdu,_AbuAbdu,1,1,0,1,5,0,0.033391593
2848014594,ibnunetwork,ibnunetwork,1,1,0,1,5,0,0.033391593
2563409423,abdallah1434201,abdallah1434201,1,2,0,2,5,1,0.082326345
1627752078,alpars18,alpars18,1,1,0,1,5,0,0.033391593
21563148,MartinBagot,MartinBagot,1,1,0,1,5,0,0.033391593
2800420634,ebumuhamed2,ebumuhamed2,1,1,0,1,5,0,0.033391593
2471135018,___Amatullah___,___Amatullah___,1,0,1,1,5,0,0
16811829,Sara__Firth,Sara__Firth,1,1,1,2,5,0,0.033391593
2777843517,husseinadms,husseinadms,1,1,0,1,5,0,0.033391593
179865422,meenanique,meenanique,1,1,0,1,5,0,0.033391593
1444120440,shvi555,shvi555,1,1,0,1,5,0,0.033391593
2730493843,12_hehe,12_hehe,1,1,0,1,5,0,0.033391593
2802976663,omarkhattab78,omarkhattab78,1,2,0,2,5,1,0.082326345
347899850,CatrinNye,CatrinNye,1,1,2,3,5,1,0.033391593
1695221761,MaryPoppins786,MaryPoppins786,1,1,0,1,5,0,0.033391593
542607362,Axharu,Axharu,1,2,0,2,5,1,0.082326345
91424773,yasinisms,yasinisms,1,3,1,4,5,0.8333333,0.092788046
2617215012,Alaa_alMuwwahid,Alaa_alMuwwahid,1,2,0,2,5,1,0.082326345
177105947,mughiratulhasan,mughiratulhasan,1,1,0,1,5,0,0.033391593
2467498242,AttySaktiningsi,AttySaktiningsi,1,2,0,2,5,1,0.043853294
2657782096,levantenaar,levantenaar,1,3,1,4,5,0.8333333,0.10703736
2720500076,Benderahitam11,Benderahitam11,1,2,0,2,5,1,0.043853294
2535131561,abdullaherhabi,abdullaherhabi,1,3,1,4,5,0.8333333,0.10703736
2283473382,1balochi,1balochi,1,2,0,2,5,1,0.043853294
933956114,AtikIsrakLemon,AtikIsrakLemon,1,2,0,2,5,1,0.082326345
2605419038,abohash10,abohash10,1,1,0,1,5,0,0.033391593
2277378617,AbdirashidHus,AbdirashidHus,1,1,0,1,5,0,0.033391593
2765392452,unknown_745,unknown_745,1,1,0,1,5,0,0.033391593
760318537,abdiwaahid,abdiwaahid,1,2,0,2,5,1,0.043853294
2785315409,alhaksyntsr,alhaksyntsr,1,1,0,1,5,0,0.033391593
137407589,anupamshri,anupamshri,1,1,0,1,5,0,0.033391593
2306804382,moleculecraze,moleculecraze,1,1,0,1,5,0,0.033391593
2755587187,alkabulee,alkabulee,1,1,0,1,5,0,0.033391593
138971898,Hana1_155,Hana1_155,1,2,0,2,5,1,0.082326345
106171184,jama250,jama250,1,1,0,1,5,0,0.033391593
135596871,N34567,N34567,1,1,0,1,5,0,0.033391593
78744392,Net_linking,Net_linking,1,1,0,1,5,0,0.033391593
2701495119,syedzahmed79,syedzahmed79,1,1,0,1,5,0,0.033391593
415203814,YasinRealme121,YasinRealme121,1,1,0,1,5,0,0.033391593
47942585,Aboujahjah,Aboujahjah,1,1,0,1,5,0,0.033391593
19237818,ben_fishwick,ben_fishwick,1,1,0,1,5,0,0.033391593
2404617160,79831337eb43420,79831337eb43420,1,1,0,1,5,0,0.033391593
2459864017,falhas47,falhas47,1,1,0,1,5,0,0.033391593
709659618,Emma51529972,Emma51529972,1,1,0,1,5,0,0.033391593
2791705638,cesc_sheikh,cesc_sheikh,1,1,0,1,5,0,0.033391593
996478081,supernurulyara,supernurulyara,1,1,0,1,5,0,0.033391593
44633229,Lateefah77,Lateefah77,1,1,1,2,5,0,0.033391593
2400928177,syahidalghazi,syahidalghazi,1,2,0,2,5,1,0.082326345
1916603635,iMuslim007,iMuslim007,1,2,0,2,5,0,0.03716184
461343997,Grimbrady1,Grimbrady1,1,1,0,1,5,0,0.033391593
2653359360,daudkhan6181,daudkhan6181,1,2,0,2,5,1,0.082326345
500698449,Abou_lesrouges,Abou_lesrouges,1,1,0,1,5,0,0.033391593
2742881638,ebu_kurdi,ebu_kurdi,1,1,0,1,5,0,0.033391593
1543638396,ZatHijabi,ZatHijabi,1,1,0,1,5,0,0.033391593
783781272,teukuindra1975,teukuindra1975,1,1,0,1,5,0,0.033391593
2827029928,mahmoudathman2,mahmoudathman2,1,1,0,1,5,0,0.033391593
2835647928,NinjaIgaWitness,NinjaIgaWitness,1,2,0,2,5,0.5,0.058102608
213749230,AbuHudayfah,AbuHudayfah,1,1,0,1,5,0,0.033391593
2787312216,514muhamed,514muhamed,1,1,0,1,5,0,0.033391593
2396360240,ManUmmat,ManUmmat,1,2,0,2,5,1,0.043853294
327355988,SabirTasnim,SabirTasnim,1,1,0,1,5,0,0.033391593
2717093484,mushimushtaq191,mushimushtaq191,1,3,0,3,5,0.8333333,0.10703736
151129739,tres_hoa,tres_hoa,1,1,1,2,5,0,0.033391593
1020858001,YousefGhazali,YousefGhazali,1,2,0,2,5,1,0.082326345
2826440389,MehmetChetnik,MehmetChetnik,1,1,0,1,5,0,0.033391593
753205897,freedomvoice199,freedomvoice199,1,1,0,1,5,0,0.033391593
966758252,abdelhafid71,abdelhafid71,1,1,0,1,5,0,0.033391593
2756939696,dersem30,dersem30,1,1,0,1,5,0,0.033391593
2591166386,sadhiq123,sadhiq123,1,2,0,2,5,1,0.043853294
2455310272,acky700,acky700,1,1,0,1,5,0,0.033391593
1057132514,7amzy,7amzy,1,2,1,3,5,1,0.082326345
1916080188,_ZoO_m0sh_,_ZoO_m0sh_,1,1,0,1,5,0,0.033391593
2191560843,ummmusaa_,ummmusaa_,1,2,1,3,5,1,0.043853294
349737127,e_james7,e_james7,1,1,0,1,5,0,0.033391593
2736984233,seemenomore7771,seemenomore7771,1,1,0,1,5,0,0.033391593
2488897716,Abu_Dahdah,Abu_Dahdah,1,1,0,1,5,0,0.033391593
493097146,Ubaah_a,Ubaah_a,1,2,1,3,5,1,0.082326345
606474466,BBCColin,BBCColin,1,1,0,1,5,0,0.033391593
1608814884,azeem_shams,azeem_shams,1,1,0,1,5,0,0.033391593
738529591,nurah66,nurah66,1,2,0,2,5,1,0.082326345
480645469,hnecati,hnecati,1,2,0,2,5,1,0.082326345
1962774889,BismaTak,BismaTak,1,2,1,3,5,1,0.082326345
387584367,seifuddeen,seifuddeen,1,1,0,1,5,0,0.033391593
2746814844,aftab_naroo,aftab_naroo,1,1,0,1,5,0,0.033391593
2558431730,ElBurroLoc0,ElBurroLoc0,1,2,0,2,5,1,0.082326345
2628981273,ummadidas,ummadidas,1,1,1,2,5,0,0.033391593
432345838,prosDONTtalkSH,prosDONTtalkSH,1,1,0,1,5,0,0.033391593
2755374552,mr_boand,mr_boand,1,2,0,2,5,1,0.082326345
2653328148,BungertKlaus,BungertKlaus,1,3,0,3,5,0.5,0.086096591
199004981,_LionessGranger,_LionessGranger,1,1,1,2,5,0,0.033391593
2566099776,JamilSaleh20,JamilSaleh20,1,1,0,1,5,0,0.033391593
2579960660,tapstrispotter,tapstrispotter,1,2,0,2,5,1,0.082326345
393384864,Haifaamohmd,Haifaamohmd,1,2,0,2,5,1,0.043853294
2575635451,aysha1st,aysha1st,1,3,0,3,5,1,0.094146014
2604766213,samadmiah92,samadmiah92,1,1,0,1,5,0,0.033391593
414815348,A_N_P_99,A_N_P_99,1,1,1,2,5,0,0.033391593
2738023958,abusumeyra,abusumeyra,1,1,0,1,5,0,0.033391593
1062759960,glotory1,glotory1,1,1,0,1,5,0,0.033391593
2741572756,can2012arkan,can2012arkan,1,1,0,1,5,0,0.033391593
1059951811,Alxgrafique,Alxgrafique,1,1,0,1,5,0,0.033391593
1686443317,Alwan_English,Alwan_English,1,0,1,1,5,0,0
519804275,AliNikmoos,AliNikmoos,1,1,0,1,5,0,0.033391593
2187597183,alhamdoullilah1,alhamdoullilah1,1,1,0,1,5,0,0.033391593
310941099,scorpionala73,scorpionala73,1,1,0,1,5,0,0.033391593
2785220071,Hikma777,Hikma777,1,1,0,1,5,0,0.033391593
2572293626,sadiiqmb,sadiiqmb,1,1,0,1,5,0,0.033391593
2421462553,Anshar004,Anshar004,1,1,0,1,5,0,0.033391593
367924861,ConstantinLager,ConstantinLager,1,1,0,1,5,0,0.033391593
1331631775,mama99925925,mama99925925,1,1,0,1,5,0,0.033391593
186226365,NickiManhaj,NickiManhaj,1,1,1,2,5,0,0.033391593
2459670206,Jabhat_03,Jabhat_03,1,1,0,1,5,0,0.033391593
903222984,Salisudayyabu2,Salisudayyabu2,1,1,0,1,5,0,0.033391593
2360317666,Talk2mickilade,Talk2mickilade,1,1,0,1,5,0,0.033391593
2537068286,AAFFBB44,AAFFBB44,1,1,0,1,5,0,0.033391593
2479494938,TwasinTashin,TwasinTashin,1,2,0,2,5,1,0.082326345
2795509582,abudua2014,abudua2014,1,4,0,4,5,0.16666667,0.07269897
1868896099,WeSpeakArabic,WeSpeakArabic,1,0,1,1,5,0,0
2310510439,Fathimathlulu,Fathimathlulu,1,1,1,2,5,0,0.033391593
1898190710,AbuHafsa__,AbuHafsa__,1,1,0,1,5,0,0.033391593
2499286915,lacosteahmad,lacosteahmad,1,1,0,1,5,0,0.033391593
2548995985,ObjectivityNews,ObjectivityNews,1,2,0,2,5,1,0.082326345
2769065904,IbnIstiyak,IbnIstiyak,1,1,0,1,5,0,0.033391593
2391087025,malikcruse,malikcruse,1,2,0,2,5,1,0.082326345
1291065301,Aliya313,Aliya313,1,1,0,1,5,0,0.033391593
2681673701,MakeupHeathen,MakeupHeathen,1,2,0,2,5,1,0.082326345
235935799,AlMusaafir94,AlMusaafir94,1,1,1,2,5,0,0.033391593
1645811810,AdDardaa,AdDardaa,1,1,0,1,5,0,0.033391593
2472398387,anwarh454,anwarh454,1,1,0,1,5,0,0.033391593
2202638502,tsuorozcoula3,tsuorozcoula3,1,1,0,1,5,0,0.033391593
245274930,EarnestCrapper,EarnestCrapper,1,4,0,4,5,0.33333334,0.072334555
228464963,lifecareuk,lifecareuk,1,1,0,1,5,0,0.033391593
2679052616,shahiideee,shahiideee,1,1,0,1,5,0,0.033391593
481008001,BinZumah,BinZumah,1,1,0,1,5,0,0.033391593
2780174757,HaditMervan,HaditMervan,1,1,0,1,5,0,0.033391593
2182879655,itaqillah_,itaqillah_,1,3,0,3,5,0.8333333,0.10703736
112564656,UmmahCalling,UmmahCalling,1,0,1,1,5,0,0
2239743056,abdurrahmanjn,abdurrahmanjn,1,1,0,1,5,0,0.033391593
520690173,Farah_Gazan,Farah_Gazan,1,1,1,2,5,0,0.033391593
2787580435,Joneh20Jone,Joneh20Jone,1,1,0,1,5,0,0.033391593
1608030853,Camp4justice,Camp4justice,1,0,1,1,5,0,0
1936530115,AkWaheedkhan,AkWaheedkhan,1,2,0,2,5,0,0.03716184
1012570884,abulhasanmahdi,abulhasanmahdi,1,2,0,2,5,1,0.082326345
2842762009,FreemixingP,FreemixingP,1,1,0,1,5,0,0.033391593
556702495,AR_Dakhil,AR_Dakhil,1,2,0,2,5,1,0.082326345
2826418837,NATOarePussys,NATOarePussys,1,1,0,1,5,0,0.033391593
2349996930,FasihahSz,FasihahSz,1,1,0,1,5,0,0.033391593
2463341505,faroukmuslym,faroukmuslym,1,1,0,1,5,0,0.033391593
1603148773,COCAsss,COCAsss,1,1,0,1,5,0,0.033391593
566723752,hassan_reepox,hassan_reepox,1,1,0,1,5,0,0.033391593
2669981525,magazz159951,magazz159951,1,1,0,1,5,0,0.033391593
502930441,AnotherAkh,AnotherAkh,1,0,1,1,5,0,0
1184570442,AmudMizori,AmudMizori,1,1,0,1,5,0,0.033391593
1187552346,frt4x,frt4x,1,0,1,1,5,0,0
2618956925,ZubayirUy,ZubayirUy,1,1,0,1,5,0,0.033391593
2762474689,VictoryFrmAllah,VictoryFrmAllah,1,2,0,2,5,1,0.082326345
1090067665,kaaami_mr,kaaami_mr,1,2,0,2,5,1,0.082326345
1006126296,an_dama_,an_dama_,1,1,0,1,5,0,0.033391593
101883166,hhugscharity,hhugscharity,1,0,1,1,5,0,0
2424741190,misket_dokuz,misket_dokuz,1,2,0,2,5,1,0.082326345
1357094276,ShkoBahezr,ShkoBahezr,1,1,0,1,5,0,0.033391593
2826804634,CaptivatingDeen,CaptivatingDeen,1,1,1,2,5,0,0.033391593
2227122074,shariyal2,shariyal2,1,1,0,1,5,0,0.033391593
752950741,Alzahuura,Alzahuura,1,1,1,2,5,0,0.033391593
2597920225,AbuHurairah1992,AbuHurairah1992,1,4,0,4,5,0.5,0.096558292
43195910,Zyenab,Zyenab,1,1,0,1,5,0,0.033391593
26386045,JonathanLKrohn,JonathanLKrohn,1,2,2,4,5,1,0.082326345
2451578499,Sideeq_Khattab,Sideeq_Khattab,1,2,0,2,5,1,0.043853294
338402980,merkdizz,merkdizz,1,1,0,1,5,0,0.033391593
2247070261,nuursulub,nuursulub,1,1,0,1,5,0,0.033391593
2795413207,harb209078,harb209078,1,1,0,1,5,0,0.033391593
2651823835,Jh70Hh,Jh70Hh,1,3,0,3,5,0.8333333,0.092788046
2447712048,UmmZarqawi,UmmZarqawi,1,3,0,3,5,0.8333333,0.092788046
401710943,MarkGKirshner,MarkGKirshner,1,1,0,1,5,0,0.033391593
1462181767,AbuabdallaM,AbuabdallaM,1,1,0,1,5,0,0.033391593
2765594512,daviesr89,daviesr89,1,1,0,1,5,0,0.033391593
2636980164,_NurAlaNur,_NurAlaNur,1,1,0,1,5,0,0.033391593
2277253069,haidar_syahid,haidar_syahid,1,1,0,1,5,0,0.033391593
726147108,aiisha_k,aiisha_k,1,1,1,2,5,0,0.033391593
39526437,serrevin,serrevin,1,2,0,2,5,1,0.043853294
2486542417,AlQamarBD,AlQamarBD,1,1,0,1,5,0,0.033391593
1140400214,fadiwitness,fadiwitness,1,2,0,2,5,1,0.082326345
2765660379,adamhitch87,adamhitch87,1,4,0,4,5,0.5,0.096558292
112959815,ixyam,ixyam,1,1,0,1,5,0,0.033391593
605856131,PirateOrg,PirateOrg,1,1,1,2,5,0,0.033391593
99459499,AnasBinHassan,AnasBinHassan,1,1,0,1,5,0,0.033391593
2544644168,AbuRabar,AbuRabar,1,1,0,1,5,0,0.033391593
2825101822,lev_muslim,lev_muslim,1,1,0,1,5,0,0.033391593
891691519,AliyahAhmedd,AliyahAhmedd,1,1,0,1,5,0,0.033391593
2347934258,shahraani,shahraani,1,2,0,2,5,1,0.043853294
2743345748,Mujahida4jihad,Mujahida4jihad,1,2,0,2,5,1,0.082326345
31728233,sirhamilton,sirhamilton,1,2,0,2,5,1,0.082326345
1922310787,AbuEssa15,AbuEssa15,1,1,0,1,5,0,0.033391593
2667127495,sajubhatt678NN,sajubhatt678NN,1,1,0,1,5,0,0.033391593
2318639829,HifzTipz,HifzTipz,1,0,1,1,5,0,0
1052615394,farouqwaalpah,farouqwaalpah,1,2,0,2,5,1,0.082326345
2707235568,mehadaziz,mehadaziz,1,2,0,2,5,1,0.082326345
2542969620,ugasroble,ugasroble,1,2,0,2,5,1,0.082326345
2510988080,FulaanSomeBody,FulaanSomeBody,1,1,0,1,5,0,0.033391593
2649629594,11_aboelwaleed,11_aboelwaleed,1,1,0,1,5,0,0.033391593
2856100800,rainingforest,rainingforest,1,1,0,1,5,0,0.033391593
533111835,khabeer75,khabeer75,1,1,1,2,5,0,0.033391593
1408279580,Nasreen_daya,Nasreen_daya,1,1,0,1,5,0,0.033391593
1004446771,roaringthelion,roaringthelion,1,2,0,2,5,1,0.082326345
299213913,sadam42,sadam42,1,1,0,1,5,0,0.033391593
2539136151,Mohamma46480058,Mohamma46480058,1,1,0,1,5,0,0.033391593
268404260,UrSoZour,UrSoZour,1,2,0,2,5,1,0.082326345
2165024019,AbuOmarmire,AbuOmarmire,1,1,0,1,5,0,0.033391593
2593006886,Aboukhatab123,Aboukhatab123,1,1,0,1,5,0,0.033391593
2536285521,MuayidAlKhilafa,MuayidAlKhilafa,1,1,1,2,5,0,0.033391593
2823824789,UmmEemarah19,UmmEemarah19,1,1,0,1,5,0,0.033391593
43328956,rick_maj,rick_maj,1,2,0,2,5,1,0.082326345
260154834,mukhtarmaa,mukhtarmaa,1,1,0,1,5,0,0.033391593
1351525861,ShayanHaqqi,ShayanHaqqi,1,1,0,1,5,0,0.033391593
2284234304,dpartsar,dpartsar,1,0,1,1,5,0,0
2404755039,samireda21,samireda21,1,1,0,1,5,0,0.033391593
2686396124,tugau_maharaja,tugau_maharaja,1,3,0,3,5,0.5,0.086096591
2819991276,IbnuFulaan1,IbnuFulaan1,1,3,0,3,5,0.8333333,0.10703736
1624778515,AbuSiqr,AbuSiqr,1,1,1,2,5,1,0.010461701
933865238,forumerindia,forumerindia,1,1,0,1,5,0,0.033391593
2324670233,Aiishaa6,Aiishaa6,1,1,0,1,5,0,0.033391593
2650941212,kiniunojoye,kiniunojoye,1,2,0,2,5,1,0.043853294
2166392459,WankhalishN,WankhalishN,1,1,0,1,5,0,0.033391593
522200923,saudkhan90,saudkhan90,1,1,0,1,5,0,0.033391593
98510707,dulmuqit,dulmuqit,1,2,0,2,5,1,0.082326345
2808260483,aslan_usame,aslan_usame,1,2,0,2,5,0.5,0.058102608
2446829478,shtetiislam,shtetiislam,1,2,0,2,5,1,0.043853294
1467951073,NurnabiFaisal,NurnabiFaisal,1,1,0,1,5,0,0.033391593
1449895920,halaljilbabi,halaljilbabi,1,0,1,1,5,0,0
94007649,hassan304,hassan304,1,1,0,1,5,0,0.033391593
2724341838,ilovekurdistan2,ilovekurdistan2,1,1,0,1,5,0,0.033391593
720054364,Mziyad96,Mziyad96,1,3,0,3,5,0.6666667,0.068564309
1881024630,moyusuf14,moyusuf14,1,2,0,2,5,1,0.082326345
2359896266,IbnOsama01,IbnOsama01,1,1,0,1,5,0,0.033391593
2317068544,slaah_alhalaby,slaah_alhalaby,1,1,0,1,5,0,0.033391593
2424613154,GamalAbuAli1,GamalAbuAli1,1,2,0,2,5,1,0.043853294
2397383002,Vib3r0n3,Vib3r0n3,1,1,0,1,5,0,0.033391593
2821040475,Redje55,Redje55,1,1,0,1,5,0,0.033391593
2847582584,aliabduallah38,aliabduallah38,1,1,0,1,5,0,0.033391593
2584422912,Gazi_Ya_Shaheed,Gazi_Ya_Shaheed,1,4,0,4,5,0.8333333,0.103696894
417770050,tunderlitning,tunderlitning,1,2,0,2,5,1,0.082326345
90122823,atoirwanto,atoirwanto,1,1,0,1,5,0,0.033391593
1548593766,SDoomie,SDoomie,1,1,1,2,5,0,0.033391593
2781194895,HidayahUmm,HidayahUmm,1,1,0,1,5,0,0.033391593
494086811,gulichester,gulichester,1,1,0,1,5,0,0.033391593
2338106102,shazziasiddiqa,shazziasiddiqa,1,1,0,1,5,0,0.033391593
497986312,Ousmoney86,Ousmoney86,1,3,0,3,5,0.8333333,0.092788046
2576722749,gulabaya,gulabaya,1,3,0,3,5,0.8333333,0.10703736
2727357250,Th3Shepherd,Th3Shepherd,1,1,0,1,5,0,0.033391593
2760813389,BALBEIK95,BALBEIK95,1,1,0,1,5,0,0.033391593
2654317563,mohamedab18,mohamedab18,1,4,0,4,5,0.75,0.117499061
2724834301,arnearne100,arnearne100,1,1,0,1,5,0,0.033391593
2599857163,abumuaz007,abumuaz007,1,2,0,2,5,1,0.082326345
1126607935,OpRohingya,OpRohingya,1,0,1,1,5,0,0
1351199815,AbdulNasserY,AbdulNasserY,1,3,0,3,5,0.8333333,0.092788046
2577706083,yaye_bintali,yaye_bintali,1,1,0,1,5,0,0.033391593
173517934,afshanmalikk,afshanmalikk,1,1,0,1,5,0,0.033391593
1307978894,Theomer1991,Theomer1991,1,3,0,3,5,0.8333333,0.092788046
2603625628,1234m21,1234m21,1,1,0,1,5,0,0.033391593
2467146928,lahilla_ahilala,lahilla_ahilala,1,1,0,1,5,0,0.033391593
2418093250,MahmodMahr,MahmodMahr,1,1,0,1,5,0,0.033391593
68332759,fathima_q,fathima_q,1,1,0,1,5,0,0.033391593
1637592326,gurabas,gurabas,1,1,0,1,5,0,0.033391593
2268638505,muslimahArifah,muslimahArifah,1,1,0,1,5,0,0.033391593
2736500017,crusader_one,crusader_one,1,1,0,1,5,0,0.033391593
47426922,karelkoulos,karelkoulos,1,2,0,2,5,1,0.082326345
1511927166,Hussamalmasri1,Hussamalmasri1,1,1,0,1,5,0,0.033391593
142978440,joharikamarudin,joharikamarudin,1,1,0,1,5,0,0.033391593
2565549470,aboumoustafaa,aboumoustafaa,1,1,0,1,5,0,0.033391593
2817437186,abuturabmujahid,abuturabmujahid,1,1,0,1,5,0,0.033391593
2591534642,oum_hanzala,oum_hanzala,1,2,1,3,5,1,0.043853294
2646978104,chairulsjaha,chairulsjaha,1,2,0,2,5,1,0.082326345
1554132559,EmirRap_Taslica,EmirRap_Taslica,1,1,0,1,5,0,0.033391593
1959898705,IbnZubair_,IbnZubair_,1,1,0,1,5,0,0.033391593
14757564,elisepotaka,elisepotaka,1,2,0,2,5,1,0.082326345
2754424619,kamranalmuslim,kamranalmuslim,1,1,0,1,5,0,0.033391593
1126805378,Hasusar99,Hasusar99,1,1,0,1,5,0,0.033391593
586330022,Mesopaq,Mesopaq,1,1,0,1,5,0,0.033391593
811544491,Siraatsalaat,Siraatsalaat,1,1,0,1,5,0,0.033391593
2696654822,mohamme98111336,mohamme98111336,1,1,0,1,5,0,0.033391593
1639198700,Tomoya_yoshi,Tomoya_yoshi,1,1,0,1,5,0,0.033391593
2756816968,Amna_K10,Amna_K10,1,1,0,1,5,0,0.033391593
1354149974,Shaffytheman,Shaffytheman,1,3,0,3,5,0.5,0.086096591
2615095421,shinqity01,shinqity01,1,2,1,3,5,0.5,0.058102608
975734810,shaykh_abdullah,shaykh_abdullah,1,1,0,1,5,0,0.033391593
2335846649,Muslims_creed,Muslims_creed,1,1,0,1,5,0,0.033391593
2565878011,Muhammad15062,Muhammad15062,1,3,0,3,5,0.8333333,0.10703736
2308223350,gemsofknowledge,gemsofknowledge,1,1,0,1,5,0,0.033391593
49656209,ejbeals,ejbeals,1,3,2,5,5,0.8333333,0.092788046
347845040,alikhashogy85,alikhashogy85,1,1,0,1,5,0,0.033391593
356757970,ibnulamiin,ibnulamiin,1,3,0,3,5,0.8333333,0.092788046
39072270,syb0rkg,syb0rkg,1,1,0,1,5,0,0.033391593
2664870445,UNIDENTIFIEDEYE,UNIDENTIFIEDEYE,1,1,0,1,5,0,0.033391593
1054913089,shaf1993man,shaf1993man,1,1,0,1,5,0,0.033391593
587510373,JumaMwalimu,JumaMwalimu,1,1,0,1,5,0,0.033391593
2767434358,ParacordOkc,ParacordOkc,1,1,0,1,5,0,0.033391593
2751771284,chocaholixx,chocaholixx,1,2,0,2,5,1,0.082326345
2784539296,udayalbaghdadi,udayalbaghdadi,1,1,0,1,5,0,0.033391593
1524937416,binhaz73,binhaz73,1,2,0,2,5,1,0.082326345
2725458706,Michelle56Evans,Michelle56Evans,1,2,0,2,5,1,0.082326345
2155885333,meknon28,meknon28,1,1,0,1,5,0,0.033391593
1716007741,Mum1a1,Mum1a1,1,1,0,1,5,0,0.033391593
2346955610,SayBismillah,SayBismillah,1,1,1,2,5,0,0.033391593
2835723169,Sharia4Australi,Sharia4Australi,1,3,0,3,5,0.5,0.086096591
588362659,khattablet,khattablet,1,1,0,1,5,0,0.033391593
2587538340,all4_1and1_4all,all4_1and1_4all,1,1,0,1,5,0,0.033391593
2752722013,khubeybtz,khubeybtz,1,1,0,1,5,0,0.033391593
600273770,MBJ_IbnAbubakar,MBJ_IbnAbubakar,1,1,0,1,5,0,0.033391593
1896395916,abmalikmansour,abmalikmansour,1,1,0,1,5,0,0.033391593
2750035094,DawudAbdullah20,DawudAbdullah20,1,2,0,2,5,1,0.082326345
1289041081,chicken_kofta,chicken_kofta,1,2,0,2,5,1,0.043853294
291779790,Timur_199,Timur_199,1,1,0,1,5,0,0.033391593
2617029857,gazaman1622,gazaman1622,1,2,0,2,5,1,0.082326345
2558309607,Ntruther,Ntruther,1,1,0,1,5,0,0.033391593
2765796588,jon_jersey,jon_jersey,1,2,0,2,5,1,0.082326345
2569352430,knight_cruize,knight_cruize,1,2,0,2,5,1,0.082326345
2271819022,SacrificeWeMake,SacrificeWeMake,1,2,0,2,5,1,0.082326345
2517258987,ali26564373,ali26564373,1,1,0,1,5,0,0.033391593
38778248,Colinfreeze,Colinfreeze,1,1,0,1,5,0,0.033391593
164345281,shakurka,shakurka,1,1,0,1,5,0,0.033391593
2276341187,bokh05,bokh05,1,1,0,1,5,0,0.033391593
2432087515,_caIorimetry,_caIorimetry,1,1,0,1,5,0,0.033391593
2420241321,ab0usama,ab0usama,1,1,0,1,5,0,0.033391593
2609395244,BelovedAiysha,BelovedAiysha,1,2,0,2,5,1,0.082326345
2379560544,emadarwina,emadarwina,1,2,0,2,5,1,0.082326345
2428482500,abukhaleed63,abukhaleed63,1,1,0,1,5,0,0.033391593
2731390622,RahmanAbu3,RahmanAbu3,1,2,0,2,5,1,0.082326345
274478755,StGeorgeIsX,StGeorgeIsX,1,2,0,2,5,1,0.082326345
2842998480,Bin_jiad,Bin_jiad,1,1,0,1,5,0,0.033391593
2555492058,kavkazcentercom,kavkazcentercom,1,1,0,1,5,0,0.033391593
2591209184,RehanAlGhuraba,RehanAlGhuraba,1,1,0,1,5,0,0.033391593
167065328,abdirii,abdirii,1,1,0,1,5,0,0.033391593
989017933,anfasmohamad,anfasmohamad,1,1,0,1,5,0,0.033391593
2578888531,hereafter03,hereafter03,1,2,0,2,5,1,0.082326345
2320250821,FFyrzal,FFyrzal,1,1,0,1,5,0,0.033391593
293648342,alleyesonjihad,alleyesonjihad,1,0,1,1,5,0,0
288617471,AfzalBodla,AfzalBodla,1,2,0,2,5,1,0.082326345
2649798684,jp784523,jp784523,1,1,0,1,5,0,0.033391593
2263201849,comanderituale,comanderituale,1,1,0,1,5,0,0.033391593
1721219154,ASWJ_Killing,ASWJ_Killing,1,2,0,2,5,1,0.043853294
2405972070,abomhijenqtr,abomhijenqtr,1,1,0,1,5,0,0.033391593
2174990453,UsmanRSheikh,UsmanRSheikh,1,0,1,1,5,0,0
1696708760,ahmad_201315,ahmad_201315,1,1,0,1,5,0,0.033391593
2820749529,1972_hamid,1972_hamid,1,2,0,2,5,1,0.082326345
2432252143,_passingIy,_passingIy,1,1,0,1,5,0,0.033391593
2507946237,riadjabel,riadjabel,1,1,0,1,5,0,0.033391593
958892425,jackmcconnel,jackmcconnel,1,1,0,1,5,0,0.033391593
438745402,MohammadAlOmair,MohammadAlOmair,1,1,0,1,5,0,0.033391593
2564340029,amjadmansour77,amjadmansour77,1,2,0,2,5,1,0.082326345
2485631402,reporTurkey,reporTurkey,1,1,0,1,5,0,0.033391593
2699004324,3zam3000,3zam3000,1,1,0,1,5,0,0.033391593
434485752,kingemirb,kingemirb,1,1,0,1,5,0,0.033391593
1537292834,freedom_khalid,freedom_khalid,1,1,0,1,5,0,0.033391593
26786386,Markdaniel444,Markdaniel444,1,3,0,3,5,0.8333333,0.092788046
2591537756,Salah860,Salah860,1,2,0,2,5,1,0.082326345
2832349823,Pob7254,Pob7254,1,2,0,2,5,1,0.082326345
2541992600,yyyh12345,yyyh12345,1,1,0,1,5,0,0.033391593
2719365816,AlQuestioner,AlQuestioner,1,2,0,2,5,1,0.082326345
381369033,KingKongBigEye,KingKongBigEye,1,1,0,1,5,0,0.033391593
2725231408,mbarakmohamed40,mbarakmohamed40,1,1,0,1,5,0,0.033391593
47814419,MiddleEastInst,MiddleEastInst,1,0,1,1,5,0,0
489077628,shannoz10,shannoz10,1,1,0,1,5,0,0.033391593
2607365083,ismaelsafi,ismaelsafi,1,3,0,3,5,0.8333333,0.092788046
2711174162,anisaq_padini,anisaq_padini,1,1,0,1,5,0,0.033391593
454953475,IS_errrrrr,IS_errrrrr,1,1,0,1,5,0,0.033391593
2613460003,khalifabanijawi,khalifabanijawi,1,2,0,2,5,1,0.082326345
424557634,QuranSpeak,QuranSpeak,1,1,1,2,5,0,0.033391593
2446212175,MimbarTauhid,MimbarTauhid,1,1,0,1,5,0,0.033391593
48544872,rassoulthiam,rassoulthiam,1,1,0,1,5,0,0.033391593
2798341070,abunasir1965,abunasir1965,1,3,0,3,5,0.8333333,0.092788046
2169650375,Oum_souleymane,Oum_souleymane,1,1,0,1,5,0,0.033391593
14335204,mustafayakub,mustafayakub,1,2,0,2,5,1,0.082326345
291749127,rahaz69,rahaz69,1,3,0,3,5,0.8333333,0.10703736
2673851665,ibnhasan9,ibnhasan9,1,1,0,1,5,0,0.033391593
2514547940,HasanMustafaS,HasanMustafaS,1,1,0,1,5,0,0.033391593
902610344,dorobalwa3ra,dorobalwa3ra,1,1,0,1,5,0,0.033391593
224705971,ahmetmukimeren,ahmetmukimeren,1,1,0,1,5,0,0.033391593
1534508520,shibl_aShaam777,shibl_aShaam777,1,2,0,2,5,1,0.043853294
204324339,enqiesweet,enqiesweet,1,1,0,1,5,0,0.033391593
917749321,montanariclaudi,montanariclaudi,1,3,0,3,5,0.8333333,0.092788046
2627386989,alkhalidy05,alkhalidy05,1,1,0,1,5,0,0.033391593
1340096186,irfanmufti0,irfanmufti0,1,1,0,1,5,0,0.033391593
2527936195,moamarbinjamal,moamarbinjamal,1,3,0,3,5,0.8333333,0.092788046
1055552803,Almushaghib,Almushaghib,1,1,0,1,5,0,0.033391593
517455615,AbedAlii,AbedAlii,1,1,0,1,5,0,0.033391593
2575122187,GreenbirdHeaven,GreenbirdHeaven,1,1,0,1,5,0,0.033391593
2778150197,imeri_ylber,imeri_ylber,1,1,0,1,5,0,0.033391593
2752298835,cadafyare12,cadafyare12,1,1,0,1,5,0,0.033391593
617430903,Allama_Iqbal_,Allama_Iqbal_,1,1,0,1,5,0,0.033391593
2530099185,genc90_musab,genc90_musab,1,1,0,1,5,0,0.033391593
151240723,aruoxam,aruoxam,1,2,0,2,5,0.5,0.058102608
41074711,conalu,conalu,1,1,0,1,5,0,0.033391593
2562998329,MalindiWebsite,MalindiWebsite,1,1,0,1,5,0,0.033391593
2650325064,IrfanAlHoque,IrfanAlHoque,1,1,0,1,5,0,0.033391593
2730082426,us_uv,us_uv,1,1,0,1,5,0,0.033391593
2493137023,22ss5,22ss5,1,1,0,1,5,0,0.033391593
935346332,MNozhatzade,MNozhatzade,1,1,0,1,5,0,0.033391593
2712584407,ShaamExclusive,ShaamExclusive,1,2,0,2,5,1,0.082326345
1891549418,freejahar02,freejahar02,1,1,1,2,5,0,0.033391593
2796306727,salaf7771,salaf7771,1,1,0,1,5,0,0.033391593
986497424,kahf_14,kahf_14,1,2,0,2,5,1,0.043853294
1883685282,CampaignIslam,CampaignIslam,1,0,2,2,5,1,0
2610545129,wokeupyet,wokeupyet,1,1,0,1,5,0,0.033391593
78365262,pjbodenham,pjbodenham,1,1,0,1,5,0,0.033391593
2574500532,abu_abdu_rahman,abu_abdu_rahman,1,1,0,1,5,0,0.033391593
247022327,JamesAALongman,JamesAALongman,1,3,0,3,5,0.5,0.086096591
2288534309,IslamicIdeas,IslamicIdeas,1,2,1,3,5,1,0.082326345
387629872,LuisaZangh,LuisaZangh,1,2,0,2,5,1,0.043853294
246989628,lostarnews,lostarnews,1,1,0,1,5,0,0.033391593
2844869497,shariahIslam,shariahIslam,1,1,0,1,5,0,0.033391593
718848892,JMuhajirah,JMuhajirah,1,2,2,4,5,0.8333333,0.043853294
340771730,Myself_00001,Myself_00001,1,2,0,2,5,1,0.043853294
25379828,ChristianneBoud,ChristianneBoud,1,2,1,3,5,1,0.082326345
545506327,SaniBinAliyu,SaniBinAliyu,1,1,0,1,5,0,0.033391593
315596977,readingsgood,readingsgood,1,1,0,1,5,0,0.033391593
2777564380,hakyoldaveti,hakyoldaveti,1,1,0,1,5,0,0.033391593
1617970448,lplamp48,lplamp48,1,1,0,1,5,0,0.033391593
2606777640,zaff_iqbal,zaff_iqbal,1,1,0,1,5,0,0.033391593
1673774420,ummusmaan1,ummusmaan1,1,1,1,2,5,0,0.033391593
1043514786,AyeshaaB96,AyeshaaB96,1,1,1,2,5,0,0.033391593
2536228292,Me01Al,Me01Al,1,3,0,3,5,0.6666667,0.068564309
1917961706,zeesh_91,zeesh_91,1,1,0,1,5,0,0.033391593
2802238964,Ibn_HasanX,Ibn_HasanX,1,1,0,1,5,0,0.033391593
323339766,Akhmad__Khabib,Akhmad__Khabib,1,1,0,1,5,0,0.033391593
2342569489,zikouz05,zikouz05,1,1,0,1,5,0,0.033391593
2449491476,aliasadullah100,aliasadullah100,1,3,0,3,5,0.16666667,0.061872854
141772361,usmanghanibutt,usmanghanibutt,1,2,0,2,5,1,0.082326345
2862817578,samybelatoui,samybelatoui,1,2,0,2,5,1,0.082326345
2608940808,AbuUsamaAlBJJ,AbuUsamaAlBJJ,1,2,0,2,5,1,0.082326345
2680964894,kakTongG,kakTongG,1,2,0,2,5,1,0.082326345
212944674,Said_alMaghrebi,Said_alMaghrebi,1,2,0,2,5,1,0.082326345
34240147,LizSly,LizSly,1,1,0,1,5,0,0.033391593
2509948800,UmIsa11,UmIsa11,1,1,0,1,5,0,0.033391593
2859943826,gt800080,gt800080,1,1,0,1,5,0,0.033391593
2267138004,sarithrachphita,sarithrachphita,1,1,0,1,5,0,0.033391593
459524061,ipekruh,ipekruh,1,2,0,2,5,1,0.082326345
2387527688,faisalukaye,faisalukaye,1,1,0,1,5,0,0.033391593
2176796694,bilmezem,bilmezem,1,1,0,1,5,0,0.033391593
1071826976,ONTAWHID,ONTAWHID,1,1,0,1,5,0,0.033391593
2495891538,MartynDrabeque,MartynDrabeque,1,1,0,1,5,0,0.033391593
2550384744,obbc400,obbc400,1,1,0,1,5,0,0.033391593
2807646338,shakitv,shakitv,1,1,0,1,5,0,0.033391593
626772127,saimkopi,saimkopi,1,1,0,1,5,0,0.033391593
2563623072,WwwSayfulla,WwwSayfulla,1,1,0,1,5,0,0.033391593
2481735893,surgeonmmk,surgeonmmk,1,1,0,1,5,0,0.033391593
167102695,alfirdaws_,alfirdaws_,1,1,1,2,5,0,0.033391593
219963782,ycidem,ycidem,1,1,0,1,5,0,0.033391593
2452932912,Chicano_Muslim,Chicano_Muslim,1,1,0,1,5,0,0.033391593
2469611846,AMINASHAMIS1,AMINASHAMIS1,1,1,0,1,5,0,0.033391593
2758920546,ishmaelsamlani,ishmaelsamlani,1,1,0,1,5,0,0.033391593
2550843775,PrincessofJanna,PrincessofJanna,1,1,0,1,5,0,0.033391593
157267699,neretvaa,neretvaa,1,1,0,1,5,0,0.033391593
1897875907,sahicham5,sahicham5,1,1,0,1,5,0,0.033391593
532990416,AdzyRado,AdzyRado,1,1,0,1,5,0,0.033391593
2169588223,dianesmuslim,dianesmuslim,1,1,0,1,5,0,0.033391593
2730019356,TheHardTruthSl,TheHardTruthSl,1,2,0,2,5,0,0.03716184
2334083706,flamingo_pete,flamingo_pete,1,4,0,4,5,0.5,0.096558292
2310687370,julaybeeeeb,julaybeeeeb,1,252,1558,1810,5,7.77E-04,0.757770016
2857585291,AbuHafsho_IPL84,AbuHafsho_IPL84,1,1,0,1,5,0,0.033391593
469617305,rodieemo,rodieemo,1,1,1,2,5,0,0.033391593
2614282969,NohShab,NohShab,1,3,0,3,5,0.8333333,0.092788046
1938180829,w1ck3d_oVo_,w1ck3d_oVo_,1,1,0,1,5,0,0.033391593
2836548353,Umm_Al_Baraa,Umm_Al_Baraa,1,1,0,1,5,0,0.033391593
22760252,clarissaward,clarissaward,1,2,1,3,5,1,0.043853294
83413854,AzharQadri,AzharQadri,1,1,0,1,5,0,0.033391593
25938867,rizwansaiyad,rizwansaiyad,1,1,0,1,5,0,0.033391593
1684556730,KhalidBouloudo,KhalidBouloudo,1,1,0,1,5,0,0.033391593
64998350,ASTAWAT,ASTAWAT,1,1,0,1,5,0,0.033391593
966904866,Bintosman_,Bintosman_,1,0,1,1,5,0,0
1641172004,AustinJohnston,AustinJohnston,1,1,0,1,5,0,0.033391593
1030114382,HizmiRidzuan,HizmiRidzuan,1,1,0,1,5,0,0.033391593
2830257289,JundAlAqsa01,JundAlAqsa01,1,0,3,3,5,1,0
2252491958,alexanas25,alexanas25,1,1,0,1,5,0,0.033391593
2424507594,gigi_gadega99,gigi_gadega99,1,1,0,1,5,0,0.033391593
2532756684,abdullahbinlad1,abdullahbinlad1,1,2,0,2,5,1,0.043853294
1111936206,IbnSaff,IbnSaff,1,2,0,2,5,1,0.082326345
603835664,ALBAN1AN,ALBAN1AN,1,1,0,1,5,0,0.033391593
447991145,Abubaze7,Abubaze7,1,2,0,2,5,1,0.082326345
2425933170,Abou_Soulayman2,Abou_Soulayman2,1,2,0,2,5,1,0.043853294
1883753845,SureshK13909931,SureshK13909931,1,1,0,1,5,0,0.033391593
1494208016,usmanalhassan5,usmanalhassan5,1,1,0,1,5,0,0.033391593
2703674918,handsomerasheed,handsomerasheed,1,1,0,1,5,0,0.033391593
2308361774,max_Truth,max_Truth,1,1,0,1,5,0,0.033391593
1738067557,mqm_21,mqm_21,1,1,0,1,5,0,0.033391593
2320453293,AmatuRahmaan1,AmatuRahmaan1,1,1,0,1,5,0,0.033391593
1656147672,elonamelo,elonamelo,1,1,0,1,5,0,0.033391593
1975078620,Farruk7Hussain,Farruk7Hussain,1,1,0,1,5,0,0.033391593
877186819,amma1343922,amma1343922,1,1,0,1,5,0,0.033391593
1057836835,jschakraborty,jschakraborty,1,2,0,2,5,1,0.043853294
2794934061,AbuAlmalhama,AbuAlmalhama,1,1,0,1,5,0,0.033391593
2841333583,AbuQuelqu1,AbuQuelqu1,1,2,0,2,5,1,0.082326345
2748698457,AbuSayf786,AbuSayf786,1,1,0,1,5,0,0.033391593
2621296537,kalfadhi,kalfadhi,1,1,0,1,5,0,0.033391593
1269944220,KamrulKHasan,KamrulKHasan,1,1,0,1,5,0,0.033391593
2284965817,AmjadBiag1,AmjadBiag1,1,2,0,2,5,0,0.03716184
366628877,Jamil7562,Jamil7562,1,1,0,1,5,0,0.033391593
739773786,khumairahri2,khumairahri2,1,1,0,1,5,0,0.033391593
2675626055,FiisabiiLiillah,FiisabiiLiillah,1,3,0,3,5,0.8333333,0.092788046
1950437467,khinamarillo,khinamarillo,1,1,0,1,5,0,0.033391593
538071135,naucoadam,naucoadam,1,1,0,1,5,0,0.033391593
215699573,soeshaw,soeshaw,1,2,0,2,5,1,0.082326345
2633617550,koinafir,koinafir,1,1,0,1,5,0,0.033391593
236867860,buttybean,buttybean,1,1,0,1,5,0,0.033391593
2506903866,abduladil1213,abduladil1213,1,1,0,1,5,0,0.033391593
117558671,twitlover10,twitlover10,1,3,0,3,5,0.8333333,0.092788046
57496097,utefanjames,utefanjames,1,1,0,1,5,0,0.033391593
2754728494,abucatar,abucatar,1,2,0,2,5,1,0.082326345
278516277,Sulymaan91,Sulymaan91,1,1,0,1,5,0,0.033391593
2696237672,khan_rizma,khan_rizma,1,1,0,1,5,0,0.033391593
2828096144,ibnhayah,ibnhayah,1,2,0,2,5,1,0.082326345
2246660793,enmhesne,enmhesne,1,0,1,1,5,0,0
2612482776,dasulafilion,dasulafilion,1,1,0,1,5,0,0.033391593
846254894,aishakharoti,aishakharoti,1,2,0,2,5,1,0.082326345
2597966660,Mujahid00000,Mujahid00000,1,1,0,1,5,0,0.033391593
526472056,abhasan125,abhasan125,1,2,0,2,5,0.5,0.058102608
2508247932,sIutty_gather,sIutty_gather,1,1,0,1,5,0,0.033391593
1657918363,Abidfarooqwarsi,Abidfarooqwarsi,1,2,0,2,5,1,0.082326345
1334170555,Azzam911911,Azzam911911,1,1,1,2,5,0,0.033391593
365515710,AsimCP,AsimCP,1,0,2,2,5,1,0
287757274,za7fdiary,za7fdiary,1,1,0,1,5,0,0.033391593
1870124005,SajidAnjali,SajidAnjali,1,1,0,1,5,0,0.033391593
1523831814,khilafajisr,khilafajisr,1,2,0,2,5,1,0.082326345
2720978049,living4jihad,living4jihad,1,2,1,3,5,1,0.082326345
1037063352,AlAustrali,AlAustrali,1,3,0,3,5,0.8333333,0.10703736
1616237784,IvanBeers,IvanBeers,1,2,0,2,5,1,0.043853294
2805654395,AliAlikedir786,AliAlikedir786,1,1,0,1,5,0,0.033391593
2705052908,ummufaizz,ummufaizz,1,1,0,1,5,0,0.033391593
1183700226,roouoo7,roouoo7,1,1,0,1,5,0,0.033391593
297588017,AishaAmatullah,AishaAmatullah,1,1,0,1,5,0,0.033391593
626644323,juheyman,juheyman,1,2,0,2,5,1,0.082326345
2697614834,7aml_Al_msk,7aml_Al_msk,1,1,0,1,5,0,0.033391593
2809386557,blackpoint__,blackpoint__,1,2,0,2,5,0,0.03716184
2305939019,IkramaMikail,IkramaMikail,1,1,0,1,5,0,0.033391593
1689540194,ZNiqabi,ZNiqabi,1,1,0,1,5,0,0.033391593
120706669,zsbi,zsbi,1,1,0,1,5,0,0.033391593
2188433111,abutalhamuhajir,abutalhamuhajir,1,2,1,3,5,1,0.082326345
2773505761,BlackAbul,BlackAbul,1,1,0,1,5,0,0.033391593
2773407474,woodzeey1,woodzeey1,1,2,0,2,5,1,0.082326345
2784781268,mshafiq790,mshafiq790,1,1,0,1,5,0,0.033391593
2449528621,Abu_Mussab,Abu_Mussab,1,1,0,1,5,0,0.033391593
166549301,Phattah_10,Phattah_10,1,1,0,1,5,0,0.033391593
200791863,omarmuqdad,omarmuqdad,1,1,0,1,5,0,0.033391593
1209128790,MozimmalH,MozimmalH,1,1,0,1,5,0,0.033391593
2768459625,1path1deenislam,1path1deenislam,1,1,0,1,5,0,0.033391593
2763282329,OutspokenSister,OutspokenSister,1,1,1,2,5,0,0.033391593
4970411,AJEnglish,AJEnglish,1,0,3,3,5,0.5,0
2801489896,YazeedMuaawiya,YazeedMuaawiya,1,1,1,2,5,0,0.033391593
2280773624,AbdullahSad8,AbdullahSad8,1,0,2,2,5,1,0
384784388,MilcahTessie,MilcahTessie,1,1,0,1,5,0,0.033391593
490068044,malki_md,malki_md,1,0,1,1,5,0,0
397203591,MuslimPrisoners,MuslimPrisoners,1,2,3,5,5,0.41666666,0.014596362
751949970,msHamadani,msHamadani,1,1,0,1,5,0,0.033391593
2582567112,BakkusMan,BakkusMan,1,2,0,2,5,1,0.082326345
2781501658,carlita_x1988,carlita_x1988,1,2,0,2,5,1,0.082326345
2708855004,arabianfze,arabianfze,1,1,0,1,5,0,0.033391593
631268390,khush_shoaib,khush_shoaib,1,1,0,1,5,0,0.033391593
591255805,Akhi_Samir,Akhi_Samir,1,1,0,1,5,0,0.033391593
432363774,secforu,secforu,1,1,0,1,5,0,0.033391593
2221922624,johnBunny3,johnBunny3,1,1,0,1,5,0,0.033391593
620255597,ShakilaKhan2,ShakilaKhan2,1,2,0,2,5,1,0.082326345
254663043,z_stranger,z_stranger,1,1,0,1,5,0,0.033391593
557504925,_UmmWaqqas,_UmmWaqqas,1,1,2,3,5,1,0.033391593
267147685,rev2outtaghout,rev2outtaghout,1,1,0,1,5,0,0.033391593
1326963254,QulAsal,QulAsal,1,1,0,1,5,0,0.033391593
333044348,studioalifba,studioalifba,1,1,1,2,5,0,0.033391593
576477871,AA98774430,AA98774430,1,1,0,1,5,0,0.033391593
414046909,cbj013,cbj013,1,2,0,2,5,1,0.082326345
413415886,IslamQoranSunna,IslamQoranSunna,1,1,0,1,5,0,0.033391593
2723568367,malakitauhid,malakitauhid,1,1,0,1,5,0,0.033391593
2288900862,MohammadAkramk,MohammadAkramk,1,2,0,2,5,1,0.082326345
2591742745,richardreport,richardreport,1,2,0,2,5,1,0.082326345
2558548798,jumaausi,jumaausi,1,1,0,1,5,0,0.033391593
874240837,7aider_3li,7aider_3li,1,1,0,1,5,0,0.033391593
2801949543,saifulislaam4,saifulislaam4,1,1,0,1,5,0,0.033391593
1938348908,muqabey,muqabey,1,2,0,2,5,1,0.082326345
64805754,akinbulut,akinbulut,1,1,0,1,5,0,0.033391593
2490620816,WorldOfIslam_,WorldOfIslam_,1,1,0,1,5,0,0.033391593
1502567324,leila3553,leila3553,1,1,1,2,5,0,0.033391593
544103396,LivingForAllah,LivingForAllah,1,0,1,1,5,0,0
2765380608,blackflagjihad,blackflagjihad,1,2,0,2,5,1,0.082326345
338713628,phatjoez,phatjoez,1,1,0,1,5,0,0.033391593
18865214,forbeesta,forbeesta,1,0,1,1,5,0,0
2572704859,Jihad411,Jihad411,1,1,0,1,5,0,0.033391593
439966848,kjul021,kjul021,1,2,0,2,5,1,0.082326345
1346952356,BasharSaleDukku,BasharSaleDukku,1,1,0,1,5,0,0.033391593
2696109246,SabrunJameel1,SabrunJameel1,1,2,0,2,5,1,0.082326345
251550912,Nas1426,Nas1426,1,1,0,1,5,0,0.033391593
251944130,waleedumran,waleedumran,1,1,0,1,5,0,0.033391593
1377983701,RezziBee,RezziBee,1,1,0,1,5,0,0.033391593
2706234586,ffelodie,ffelodie,1,1,0,1,5,0,0.033391593
436755736,Raawiya81,Raawiya81,1,1,0,1,5,0,0.033391593
1863711306,umsufyaan,umsufyaan,1,2,1,3,5,1,0.043853294
117333445,rizalardin,rizalardin,1,1,0,1,5,0,0.033391593
2631720401,Abufellahlevant,Abufellahlevant,1,1,0,1,5,0,0.033391593
2768920027,KasymAbdul,KasymAbdul,1,1,0,1,5,0,0.033391593
2814074360,salafi2196,salafi2196,1,2,0,2,5,1,0.082326345
1431690763,mamun1924,mamun1924,1,1,0,1,5,0,0.033391593
2600656550,igreenbird,igreenbird,1,1,0,1,5,0,0.033391593
2828132047,mojidkasari,mojidkasari,1,2,0,2,5,0.5,0.058102608
751787803,PakAfghanNews7,PakAfghanNews7,1,2,1,3,5,0.8333333,0.043853294
216797147,tahirkhan1985,tahirkhan1985,1,2,0,2,5,1,0.082326345
2490097459,hfjfvvg,hfjfvvg,1,1,0,1,5,0,0.033391593
1947066186,ismailebrahim11,ismailebrahim11,1,1,0,1,5,0,0.033391593
2263211935,ebubedir1,ebubedir1,1,1,0,1,5,0,0.033391593
335765438,imamanwara,imamanwara,1,4,0,4,5,0.75,0.117499061
2304958406,TechAccparts,TechAccparts,1,1,0,1,5,0,0.033391593
2629132231,ebumusab_islam,ebumusab_islam,1,1,0,1,5,0,0.033391593
2727731159,KunnaJibaalan,KunnaJibaalan,1,1,0,1,5,0,0.033391593
2555830266,_AbuDawud,_AbuDawud,1,1,1,2,5,0,0.033391593
237232213,PurpleRuby8,PurpleRuby8,1,1,0,1,5,0,0.033391593
198238302,OfficialMohsin,OfficialMohsin,1,1,1,2,5,0,0.033391593
972611803,alubudiyyah,alubudiyyah,1,1,2,3,5,1,0.033391593
293429489,Ansariyya,Ansariyya,1,1,2,3,5,1,0.033391593
889698470,CassKhattab,CassKhattab,1,1,0,1,5,0,0.033391593
2441699670,samir19778,samir19778,1,1,0,1,5,0,0.033391593
19063141,sandssidhu,sandssidhu,1,2,0,2,5,1,0.082326345
1463312762,IzalcoPm,IzalcoPm,1,1,0,1,5,0,0.033391593
2683986303,Dove3551,Dove3551,1,1,0,1,5,0,0.033391593
6316452,tmod,tmod,1,1,0,1,5,0,0.033391593
2481545675,mohammad1444423,mohammad1444423,1,2,0,2,5,1,0.043853294
932040786,saifuoallah,saifuoallah,1,1,0,1,5,0,0.033391593
21062148,OceanoDeAzahar,OceanoDeAzahar,1,1,0,1,5,0,0.033391593
2698011164,mayak_nuclear,mayak_nuclear,1,1,0,1,5,0,0.033391593
142238250,fajrsky,fajrsky,1,2,0,2,5,1,0.082326345
379937326,6RYAN9,6RYAN9,1,1,0,1,5,0,0.033391593
2639946376,BeginsMartin,BeginsMartin,1,1,0,1,5,0,0.033391593
1438048910,UmmAbuBakr101,UmmAbuBakr101,1,1,0,1,5,0,0.033391593
2548425367,_Sumalee_1,_Sumalee_1,1,2,1,3,5,1,0.082326345
714788975,saaka14,saaka14,1,1,0,1,5,0,0.033391593
117203647,buraaq99,buraaq99,1,1,0,1,5,0,0.033391593
2808013539,AbuMohammed_MS,AbuMohammed_MS,1,0,1,1,5,0,0
2494391043,H_Ismayiloglu,H_Ismayiloglu,1,1,0,1,5,0,0.033391593
2460362198,xugkar39,xugkar39,1,1,0,1,5,0,0.033391593
2463392534,TGR778,TGR778,1,1,0,1,5,0,0.033391593
329933698,ZaxoCan80,ZaxoCan80,1,3,0,3,5,0.5,0.093152461
2231100340,taher6616,taher6616,1,1,0,1,5,0,0.033391593
463430611,MuhdazamAzmi,MuhdazamAzmi,1,3,0,3,5,0.5,0.093152461
32957409,Caltha,Caltha,1,2,0,2,5,0,0.03716184
2536498168,parisayas,parisayas,1,1,0,1,5,0,0.033391593
2687099910,sasuhan265,sasuhan265,1,1,0,1,5,0,0.033391593
2599642123,IDOahafda,IDOahafda,1,1,0,1,5,0,0.033391593
2481677335,AbuIklas,AbuIklas,1,1,0,1,5,0,0.033391593
1681941541,loverofMadina,loverofMadina,1,0,1,1,5,0,0
2577654834,ziyad_lad,ziyad_lad,1,1,0,1,5,0,0.033391593
2361812030,Abumusabassuri,Abumusabassuri,1,1,1,2,5,0,0.033391593
403334227,Ummsahl,Ummsahl,1,2,0,2,5,1,0.043853294
501736589,BahrenNurdin13,BahrenNurdin13,1,1,0,1,5,0,0.033391593
2609538194,MFolower,MFolower,1,1,0,1,5,0,0.033391593
413787309,Kamana_48,Kamana_48,1,1,0,1,5,0,0.033391593
540763310,aibakyt,aibakyt,1,1,0,1,5,0,0.033391593
547153138,maherakraa,maherakraa,1,1,0,1,5,0,0.033391593
2478990602,AishaMuslimah20,AishaMuslimah20,1,1,0,1,5,0,0.033391593
2210227519,Ummuomar1,Ummuomar1,1,2,0,2,5,1,0.043853294
2822792521,AmirRuf,AmirRuf,1,1,0,1,5,0,0.033391593
496723277,khawaja_ameer,khawaja_ameer,1,3,0,3,5,0.8333333,0.092788046
1521902954,moakhan_,moakhan_,1,1,1,2,5,0,0.033391593
270329248,BintAfghanistan,BintAfghanistan,1,2,0,2,5,0,0.03716184
766535096,AbuAishah_,AbuAishah_,1,1,2,3,5,1,0.033391593
2653021658,AbdhamedN,AbdhamedN,1,1,0,1,5,0,0.033391593
2288674374,karidda,karidda,1,3,2,5,5,0.8333333,0.092788046
954590804,planetepics,planetepics,1,0,1,1,5,0,0
173860467,ukhtiEla,ukhtiEla,1,1,0,1,5,0,0.033391593
2606163679,MuWiro,MuWiro,1,3,0,3,5,0.8333333,0.092788046
2597185261,Aabir_EC,Aabir_EC,1,1,0,1,5,0,0.033391593
633235197,Humii_R,Humii_R,1,0,1,1,5,0,0
2654594852,Fuckisrael35,Fuckisrael35,1,3,0,3,5,0.8333333,0.092788046
2760719334,sa23882302,sa23882302,1,1,0,1,5,0,0.033391593
2470242216,GgjhIbui,GgjhIbui,1,1,0,1,5,0,0.033391593
371746759,kuhelChowdhury,kuhelChowdhury,1,1,0,1,5,0,0.033391593
550365143,strivingsalafi,strivingsalafi,1,0,1,1,5,0,0
2415028214,FarooqiFamily,FarooqiFamily,1,0,1,1,5,0,0
2795366435,tetra_koiwai,tetra_koiwai,1,1,0,1,5,0,0.033391593
1042688059,Shadabasad,Shadabasad,1,1,0,1,5,0,0.033391593
2731993140,shendjj,shendjj,1,1,0,1,5,0,0.033391593
2573527130,USABROTHERS4JN,USABROTHERS4JN,1,1,0,1,5,0,0.033391593
2426071140,JihadiStuff,JihadiStuff,1,2,2,4,5,1,0.082326345
529688830,NadimShema,NadimShema,1,1,0,1,5,0,0.033391593
168328240,TauneWe,TauneWe,1,3,1,4,5,0.8333333,0.092788046
2408475008,MuhammadAlAseem,MuhammadAlAseem,1,2,0,2,5,0.5,0.058102608
2518301762,mektebierkam,mektebierkam,1,2,0,2,5,1,0.043853294
2735565220,bintstefano,bintstefano,1,1,0,1,5,0,0.033391593
259746229,MrSoikot,MrSoikot,1,2,0,2,5,1,0.082326345
2405427652,Elkabeer8,Elkabeer8,1,1,0,1,5,0,0.033391593
950102479,admbrr,admbrr,1,2,0,2,5,0.5,0.058102608
2198563282,55Ataallahslom,55Ataallahslom,1,1,0,1,5,0,0.033391593
2806770180,theretra,theretra,1,4,0,4,5,0.75,0.117499061
2565564936,numenor51,numenor51,1,1,0,1,5,0,0.033391593
2844420618,dhia_alazmi,dhia_alazmi,1,1,0,1,5,0,0.033391593
1881762366,MyDeenIsSuccess,MyDeenIsSuccess,1,1,1,2,5,0,0.033391593
746678940,abba_hamisu,abba_hamisu,1,1,0,1,5,0,0.033391593
2554030806,Abasit_Baloch,Abasit_Baloch,1,1,0,1,5,0,0.033391593
2778196846,ghamad222,ghamad222,1,1,0,1,5,0,0.033391593
2729470839,blackglass__,blackglass__,1,1,0,1,5,0,0.033391593
1851779972,fuadf58,fuadf58,1,2,0,2,5,1,0.043853294
2398743433,Kilafah101,Kilafah101,1,2,0,2,5,1,0.043853294
2747591576,hamraf2,hamraf2,1,1,0,1,5,0,0.033391593
16509897,bensears1,bensears1,1,1,0,1,5,0,0.033391593
885091279,A3iya,A3iya,1,1,0,1,5,0,0.033391593
2440064007,Abou_Jundullah,Abou_Jundullah,1,1,0,1,5,0,0.033391593
1123413001,harrad2,harrad2,1,3,0,3,5,0.8333333,0.092788046
35449951,junnie147,junnie147,1,1,0,1,5,0,0.033391593
950074555,MuhammadDavisAm,MuhammadDavisAm,1,3,1,4,5,0.8333333,0.092788046
1557621902,abuhamzay,abuhamzay,1,1,0,1,5,0,0.033391593
1516858586,95Marium,95Marium,1,0,1,1,5,0,0
2366926075,naruto188568113,naruto188568113,1,2,0,2,5,1,0.043853294
2595843420,baftirovski,baftirovski,1,1,0,1,5,0,0.033391593
2574118316,UmmMuadh__,UmmMuadh__,1,1,0,1,5,0,0.033391593
1287187904,ifthimatrix,ifthimatrix,1,3,0,3,5,0.16666667,0.047987956
545156632,AzadMiaaah,AzadMiaaah,1,1,0,1,5,0,0.033391593
460353134,walidahmeddinat,walidahmeddinat,1,1,0,1,5,0,0.033391593
1317498500,iswgi,iswgi,1,1,0,1,5,0,0.033391593
2304536324,mercurius_ch,mercurius_ch,1,1,0,1,5,0,0.033391593
1428156187,navidkhan76,navidkhan76,1,5,0,5,5,0.6,0.146851012
2744446810,GR198224,GR198224,1,1,0,1,5,0,0.033391593
2223730556,HooyoCanjeelo,HooyoCanjeelo,1,1,0,1,5,0,0.033391593
2587848593,abujibril1986,abujibril1986,1,2,0,2,5,1,0.082326345
2779441142,ndooshndoosh201,ndooshndoosh201,1,1,0,1,5,0,0.033391593
2682974154,AbuYaser70,AbuYaser70,1,1,0,1,5,0,0.033391593
2652303313,god00lover,god00lover,1,2,0,2,5,0,0.03716184
122941434,abusamir02,abusamir02,1,1,0,1,5,0,0.033391593
2273046569,ingush55,ingush55,1,1,0,1,5,0,0.033391593
2766401680,allahsabd,allahsabd,1,4,0,4,5,0.5,0.096558292
2812834013,AbbasRaucci,AbbasRaucci,1,1,0,1,5,0,0.033391593
2592436488,alfarisfarisi00,alfarisfarisi00,1,1,0,1,5,0,0.033391593
260010301,Donrok,Donrok,1,1,0,1,5,0,0.033391593
2835444062,7_untel,7_untel,1,1,0,1,5,0,0.033391593
1929179490,Mikewesten73,Mikewesten73,1,1,0,1,5,0,0.033391593
495841653,izdsy,izdsy,1,3,0,3,5,0.6666667,0.068564309
2732814744,HabibHabob12,HabibHabob12,1,1,0,1,5,0,0.033391593
710668713,Salafi_Queen_,Salafi_Queen_,1,1,1,2,5,0,0.033391593
502854110,Mshairk_Shaikh,Mshairk_Shaikh,1,1,0,1,5,0,0.033391593
1830777355,J_Adebolajo,J_Adebolajo,1,0,1,1,5,0,0
2598105625,farshadyari1,farshadyari1,1,2,0,2,5,1,0.082326345
202240633,shilon47,shilon47,1,1,0,1,5,0,0.033391593
271282819,natapala,natapala,1,1,0,1,5,0,0.033391593
2768958139,abukeyya,abukeyya,1,2,0,2,5,1,0.082326345
2270130906,nice_OWL,nice_OWL,1,1,1,2,5,0,0.033391593
2703881048,soulwitnesss,soulwitnesss,1,2,0,2,5,1,0.082326345
2162258809,dramintab,dramintab,1,1,0,1,5,0,0.033391593
2701333321,ralam8093,ralam8093,1,1,0,1,5,0,0.033391593
1567060951,elmusaafir,elmusaafir,1,2,0,2,5,0.5,0.058102608
1468396512,AcehIlhamna5031,AcehIlhamna5031,1,1,0,1,5,0,0.033391593
2513859566,al_kanadi,al_kanadi,1,3,2,5,5,0.8333333,0.092788046
1327297538,SarahElSayed_1,SarahElSayed_1,1,1,0,1,5,0,0.033391593
2220454928,mujahidbilalaus,mujahidbilalaus,1,2,0,2,5,1,0.043853294
2653025349,M_Taylor_Kiwi,M_Taylor_Kiwi,1,1,0,1,5,0,0.033391593
2837607505,mkashifbilal12,mkashifbilal12,1,2,0,2,5,1,0.043853294
2706109566,saraadamsyr,saraadamsyr,1,1,0,1,5,0,0.033391593
2797922499,selei3,selei3,1,2,0,2,5,0.5,0.058102608
35058865,osamaazam40,osamaazam40,1,1,0,1,5,0,0.033391593
2314794179,FreeRuqya,FreeRuqya,1,1,0,1,5,0,0.033391593
2385343778,IIhla,IIhla,1,1,0,1,5,0,0.033391593
2420700464,nooralislam009,nooralislam009,1,2,0,2,5,1,0.082326345
731936082,ahmadalokdeh1,ahmadalokdeh1,1,1,0,1,5,0,0.033391593
2839139227,sohailbirmani,sohailbirmani,1,1,0,1,5,0,0.033391593
2463593893,AlNidaaMedia,AlNidaaMedia,1,1,1,2,5,1,0.033391593
2782295463,omar38932,omar38932,1,2,0,2,5,1,0.043853294
2352281037,UmmahMoja,UmmahMoja,1,1,1,2,5,0,0.033391593
249263574,QR_Blog,QR_Blog,1,0,1,1,5,0,0
356972011,kashmir4ever,kashmir4ever,1,1,1,2,5,0,0.033391593
2371024431,illatoke,illatoke,1,1,0,1,5,0,0.033391593
2718660151,rajmanipuram,rajmanipuram,1,1,0,1,5,0,0.033391593
2346382909,TTelnik,TTelnik,1,1,0,1,5,0,0.033391593
1131083328,IndoE_t,IndoE_t,1,1,0,1,5,0,0.033391593
2619045444,edisefas,edisefas,1,1,0,1,5,0,0.033391593
381580913,amalina_shah,amalina_shah,1,1,0,1,5,0,0.033391593
2810378011,Khalid_Singa,Khalid_Singa,1,4,0,4,5,0.5,0.096558292
1074165552,abuSiNiIf,abuSiNiIf,1,2,0,2,5,0,0.03716184
2605610918,AbuHamzaAlHind,AbuHamzaAlHind,1,3,0,3,5,0.8333333,0.092788046
2289334262,Rinanr41,Rinanr41,1,1,0,1,5,0,0.033391593
1316059201,lawal_alhassan,lawal_alhassan,1,1,0,1,5,0,0.033391593
398161987,ReehanAhnaf,ReehanAhnaf,1,2,0,2,5,1,0.082326345
1393490005,Abdullah1Azzam,Abdullah1Azzam,1,0,1,1,5,0,0
2420471902,onthetawheed,onthetawheed,1,1,0,1,5,0,0.033391593
724334718,Usaama89,Usaama89,1,0,1,1,5,0,0
1640545645,molviopath,molviopath,1,3,1,4,5,0.8333333,0.092788046
2835413192,journomatt1,journomatt1,1,1,0,1,5,0,0.033391593
1440741583,SHAYAALSHMARY,SHAYAALSHMARY,1,1,0,1,5,0,0.033391593
2841868586,kakatomo47,kakatomo47,1,1,0,1,5,0,0.033391593
2412050810,Hassanito7,Hassanito7,1,2,0,2,5,1,0.043853294
2443704876,Ibnul_Hattap,Ibnul_Hattap,1,2,0,2,5,1,0.043853294
953023050,SandalGalaxy,SandalGalaxy,1,2,0,2,5,0.5,0.058102608
2810149460,ResidentZero777,ResidentZero777,1,1,0,1,5,0,0.033391593
2463529557,Naaasirah_,Naaasirah_,1,1,0,1,5,0,0.033391593
409041513,lopsy786,lopsy786,1,1,0,1,5,0,0.033391593
2805627513,AlSomali9,AlSomali9,1,2,0,2,5,1,0.082326345
47741609,MuslimsDebate,MuslimsDebate,1,1,0,1,5,0,0.033391593
2799645501,omaradam2140,omaradam2140,1,2,0,2,5,1,0.082326345
1589148368,Bird_Of_Janah,Bird_Of_Janah,1,2,1,3,5,1,0.043853294
2606267123,qurashia_baqia,qurashia_baqia,1,2,0,2,5,1,0.043853294
2519956284,AbuUthmaan007,AbuUthmaan007,1,1,0,1,5,0,0.033391593
138476358,m_a_o_o_a_,m_a_o_o_a_,1,1,0,1,5,0,0.033391593
2741730148,jimitoeppp,jimitoeppp,1,2,0,2,5,1,0.082326345
1022294935,DreadMuslim,DreadMuslim,1,2,0,2,5,1,0.082326345
2157214679,Fahd7717,Fahd7717,1,1,0,1,5,0,0.033391593
2360474612,Rinald_2,Rinald_2,1,1,0,1,5,0,0.033391593
2597871558,UmarKhatta,UmarKhatta,1,2,0,2,5,1,0.082326345
2669018981,GreenbirdZubayr,GreenbirdZubayr,1,2,0,2,5,1,0.082326345
2579332213,TamimDarry,TamimDarry,1,1,0,1,5,0,0.033391593
2481290467,hgit43e,hgit43e,1,1,0,1,5,0,0.033391593
237993209,syathirdani,syathirdani,1,1,0,1,5,0,0.033391593
2290023684,abokhafa,abokhafa,1,1,0,1,5,0,0.033391593
815922456,ismailnku,ismailnku,1,2,0,2,5,1,0.082326345
157285658,yaskalani,yaskalani,1,1,0,1,5,0,0.033391593
2483211254,11113Mfayez,11113Mfayez,1,1,0,1,5,0,0.033391593
2757655881,_niqabii,_niqabii,1,1,0,1,5,0,0.033391593
1525644632,SyrianGirl_,SyrianGirl_,1,1,1,2,5,0,0.033391593
2368011732,Jak_Ali_,Jak_Ali_,1,1,2,3,5,1,0.033391593
2373484031,9111AHMAD,9111AHMAD,1,1,0,1,5,0,0.033391593
2422144531,MThair77,MThair77,1,2,0,2,5,1,0.043853294
2341273525,MiraeMus96,MiraeMus96,1,1,0,1,5,0,0.033391593
1970601542,ifahshahnaz,ifahshahnaz,1,1,0,1,5,0,0.033391593
2583428706,NIbneZ1,NIbneZ1,1,1,0,1,5,0,0.033391593
2720366292,ScourgeUndrwrld,ScourgeUndrwrld,1,1,0,1,5,0,0.033391593
2646146796,umm_yahya00,umm_yahya00,1,1,0,1,5,0,0.033391593
2819653372,johnbra63937665,johnbra63937665,1,1,0,1,5,0,0.033391593
2213773118,FurkanKavkaz,FurkanKavkaz,1,1,0,1,5,0,0.033391593
2347663205,hunaydha,hunaydha,1,2,0,2,5,1,0.082326345
481689446,lookin4aladdin,lookin4aladdin,1,1,1,2,5,0,0.033391593
201654128,ummmuawiyahh,ummmuawiyahh,1,0,1,1,5,0,0
2420375550,abouobayda11,abouobayda11,1,1,0,1,5,0,0.033391593
2357657600,ahmadalkatiri5,ahmadalkatiri5,1,1,0,1,2,0,0.010461701
242679818,william819661,william819661,1,1,0,1,2,0,0.010461701
2261701975,HabibaalGhareeb,HabibaalGhareeb,1,1,0,1,2,0,0.010461701
241401883,dabozza,dabozza,1,1,0,1,2,0,0.010461701
1911980112,VeiledVoice,VeiledVoice,1,2,0,2,2,0.5,0.059396452
2656206963,bruton70,bruton70,1,1,0,1,2,0,0.010461701
2723610783,2Tetrakoiwai,2Tetrakoiwai,1,1,0,1,2,0,0.010461701
283738281,Normaj232,Normaj232,1,1,0,1,2,0,0.010461701
2185920714,muhsinman0,muhsinman0,1,2,0,2,2,1,0.043853294
601063639,nayeem78605043,nayeem78605043,1,2,0,2,2,0.5,0.059396452
363659496,manolo040,manolo040,1,1,0,1,2,0,0.010461701
4090581,GroverCleveland,GroverCleveland,1,1,0,1,2,0,0.010461701
1672708356,_MATNIS_,_MATNIS_,1,1,0,1,2,0,0.010461701
210043152,alextieleman,alextieleman,1,1,0,1,2,0,0.010461701
2732982557,_Warriorofislam,_Warriorofislam,1,1,0,1,2,0,0.010461701
2500428096,arslanalfatih,arslanalfatih,1,1,0,1,2,0,0.010461701
2179760454,BelanLondon,BelanLondon,1,1,0,1,2,0,0.010461701
112066899,spikeuberss,spikeuberss,1,1,0,1,2,0,0.010461701
2188181853,Umm_AbderRahman,Umm_AbderRahman,1,1,0,1,2,0,0.010461701
2730000799,NinaArpine,NinaArpine,1,1,0,1,2,0,0.010461701
2337243578,bintabdulfatah,bintabdulfatah,1,1,0,1,2,0,0.010461701
2272297446,peduliisis,peduliisis,1,1,0,1,2,0,0.010461701
2749071857,samjenkins42,samjenkins42,1,1,0,1,2,0,0.010461701
67568216,AbuAbdulWadood,AbuAbdulWadood,1,1,0,1,2,0,0.010461701
2324955748,ps32023,ps32023,1,3,0,3,2,0.8333333,0.092788046
1646379116,MonsurKhattab,MonsurKhattab,1,1,0,1,2,0,0.010461701
2263810719,andaluze09,andaluze09,1,1,0,1,2,0,0.010461701
2333377196,marya_dawlah,marya_dawlah,1,1,0,1,2,0,0.010461701
385811128,DunyaWeary,DunyaWeary,1,1,0,1,2,0,0.010461701
1016857296,Abu_azzam81,Abu_azzam81,1,1,0,1,2,0,0.010461701
44204763,FunkyDisciple,FunkyDisciple,1,1,0,1,2,0,0.010461701
2311684841,rahmani007ltd,rahmani007ltd,1,1,0,1,2,0,0.010461701
1849033530,wise_meerkat,wise_meerkat,1,1,0,1,2,0,0.010461701
2304738107,abu_azzam85,abu_azzam85,1,1,0,1,2,0,0.010461701
1889698622,haidarabbas94,haidarabbas94,1,1,0,1,2,0,0.010461701
758022978,humara94,humara94,1,1,0,1,2,0,0.010461701
2488992588,AbuAbouk,AbuAbouk,1,1,0,1,2,0,0.010461701
160760802,YogiDarwis,YogiDarwis,1,1,0,1,2,0,0.010461701
1449072140,Vacrovski,Vacrovski,1,4,0,4,2,0.75,0.117499061
2370995280,AbdalYasu,AbdalYasu,1,2,0,2,2,0,0.014231947
1168966850,Nuaymah,Nuaymah,1,2,0,2,2,0.5,0.059396452
20120795,cherie2301,cherie2301,1,2,0,2,2,1,0.043853294
2556265728,AbdulQasimAlMuj,AbdulQasimAlMuj,1,1,0,1,2,0,0.010461701
825984390,As_Somaal,As_Somaal,1,4,0,4,2,0.5,0.096558292
2291402274,KniightRyder,KniightRyder,1,5,0,5,2,0.6,0.146851012
312575533,hevar95,hevar95,1,2,0,2,2,1,0.043853294
1477019203,smartsmile1993,smartsmile1993,1,1,0,1,2,0,0.010461701
42403463,De_Peet,De_Peet,1,1,0,1,2,0,0.010461701
2691106454,ecd5ca24edfc415,ecd5ca24edfc415,1,1,0,1,2,0,0.010461701
2345338525,Dawlatulislam,Dawlatulislam,1,1,0,1,2,0,0.010461701
2302838466,MuslimResistanc,MuslimResistanc,1,1,0,1,2,0,0.010461701
2494793449,Taim_al_Amriki,Taim_al_Amriki,1,1,0,1,2,0,0.010461701
73336558,pexwaz,pexwaz,1,1,0,1,2,0,0.010461701
141199170,UmmAfnaan,UmmAfnaan,1,1,0,1,2,0,0.010461701
1440941929,Calm__quiet,Calm__quiet,1,2,0,2,2,0.5,0.059396452
2761557876,mkhan192,mkhan192,1,2,1,3,2,0.5,0.059396452
2542307206,121abdurRahman,121abdurRahman,1,1,0,1,2,0,0.010461701
2211317676,OptimisticReb11,OptimisticReb11,1,1,0,1,2,0,0.010461701
2612168773,grout3362,grout3362,1,4,0,4,2,0.41666666,0.087877713
267061322,2Tuune,2Tuune,1,3,1,4,2,0.8333333,0.092788046
2601977942,ilovealla099755,ilovealla099755,1,1,0,1,2,0,0.010461701
2795210848,higihko,higihko,1,1,0,1,2,0,0.010461701
2410219715,25Alnoofy,25Alnoofy,1,1,0,1,2,0,0.010461701
2213120223,TalebZahran,TalebZahran,1,1,0,1,2,0,0.010461701
44632292,feyss,feyss,1,1,0,1,2,0,0.010461701
2236410925,saharawe5,saharawe5,1,1,0,1,2,0,0.010461701
55478546,JubzyWubzy,JubzyWubzy,1,1,0,1,2,0,0.010461701
34439555,Niqaabique,Niqaabique,1,1,0,1,2,0,0.010461701
1295780120,flowers51084527,flowers51084527,1,1,0,1,2,0,0.010461701
91621671,onlinejihad,onlinejihad,1,1,0,1,2,0,0.010461701
246450482,Jamiltunis,Jamiltunis,1,1,0,1,2,0,0.010461701
2578909513,coreofsnr,coreofsnr,1,1,0,1,2,0,0.010461701
392628554,muhammad718,muhammad718,1,1,0,1,2,0,0.010461701
213584387,Independist,Independist,1,2,0,2,2,1,0.043853294
1946479711,UKhtiSomaliyah,UKhtiSomaliyah,1,1,0,1,2,0,0.010461701
2715191880,irfanzai19841,irfanzai19841,1,2,0,2,2,1,0.043853294
2338949733,farooq_a1,farooq_a1,1,1,0,1,2,0,0.010461701
2433354391,Al_Bakri_,Al_Bakri_,1,1,0,1,2,0,0.010461701
1887439562,umm_nusaybah01,umm_nusaybah01,1,1,0,1,2,0,0.010461701
1613597412,Altaifamansoora,Altaifamansoora,1,2,0,2,2,1,0.043853294
2203388652,MikeDodsonGGGRC,MikeDodsonGGGRC,1,1,0,1,2,0,0.010461701
2389314304,abujihad122,abujihad122,1,1,1,2,2,0.5,0.010461701
1474693915,ASpublicaties,ASpublicaties,1,1,0,1,2,0,0.010461701
2510293803,albasat762,albasat762,1,1,0,1,2,0,0.010461701
2178583353,ibnRawaaha,ibnRawaaha,1,1,0,1,2,0,0.010461701
979307354,ShizenOyake,ShizenOyake,1,1,0,1,2,0,0.010461701
557648822,SaidiAlMuzani1,SaidiAlMuzani1,1,1,0,1,2,0,0.010461701
370379711,kabirakhan,kabirakhan,1,1,0,1,2,0,0.010461701
2612530164,tedi112,tedi112,1,1,0,1,2,0,0.010461701
1018235898,birik_mohamed,birik_mohamed,1,1,0,1,2,0,0.010461701
854395904,HaidarMohammedd,HaidarMohammedd,1,1,0,1,2,0,0.010461701
112102422,fleetoAllahswt,fleetoAllahswt,1,2,0,2,2,1,0.043853294
2205849435,FatimaFarah_18,FatimaFarah_18,1,1,0,1,2,0,0.010461701
2521992237,hassensaoud2,hassensaoud2,1,1,0,1,2,0,0.010461701
1208028313,fahdiii1,fahdiii1,1,1,0,1,2,0,0.010461701
2492370107,Kb92Mu,Kb92Mu,1,2,0,2,2,1,0.043853294
186715338,oonaught,oonaught,1,1,0,1,2,0,0.010461701
2160790756,AbdulmalikSul11,AbdulmalikSul11,1,2,0,2,2,0.5,0.059396452
2232028426,kashifmuslim313,kashifmuslim313,1,1,0,1,2,0,0.010461701
113642820,Aiman1979,Aiman1979,1,1,0,1,2,0,0.010461701
352488778,Amlil71,Amlil71,1,1,0,1,2,0,0.010461701
2272759197,sahalmoha211,sahalmoha211,1,1,0,1,2,0,0.010461701
2148928942,mz90000,mz90000,1,1,0,1,2,0,0.010461701
353865165,sarahrana9,sarahrana9,1,2,0,2,2,0,0.014231947
633671122,mkosmic,mkosmic,1,2,0,2,2,1,0.043853294
1468075490,Intr8vert,Intr8vert,1,1,0,1,2,0,0.010461701
916950553,seda_ygmr,seda_ygmr,1,1,0,1,2,0,0.010461701
184684104,zarkavi,zarkavi,1,1,0,1,2,0,0.010461701
2694516336,IbadaAbuMusa,IbadaAbuMusa,1,2,0,2,2,1,0.043853294
371461760,fahmigazi,fahmigazi,1,1,0,1,2,0,0.010461701
1900154514,AbiAasim,AbiAasim,1,1,0,1,2,0,0.010461701
2457308908,MutarrBarry,MutarrBarry,1,1,0,1,2,0,0.010461701
2584547110,Muslymme,Muslymme,1,2,0,2,2,0.5,0.035172715
239734576,noumanafza_1988,noumanafza_1988,1,1,0,1,2,0,0.010461701
2709950293,dawlakh,dawlakh,1,1,0,1,2,0,0.010461701
418877283,revqib,revqib,1,1,0,1,2,0,0.010461701
2453180275,ansaariyeen,ansaariyeen,1,1,0,1,2,0,0.010461701
2294124415,GreenSea14,GreenSea14,1,1,0,1,2,0,0.010461701
1456607136,abusufyaaan,abusufyaaan,1,1,0,1,2,0,0.010461701
2432735234,Mujahideen670,Mujahideen670,1,2,0,2,2,0.5,0.059396452
369987632,westrandse,westrandse,1,1,0,1,2,0,0.010461701
1651085364,hendri1777,hendri1777,1,1,0,1,2,0,0.010461701
1594232906,4010234,4010234,1,1,0,1,2,0,0.010461701
1842155598,saeed3334326,saeed3334326,1,1,0,1,2,0,0.010461701
1635946579,ExcesIm,ExcesIm,1,1,0,1,2,0,0.010461701
436736098,sojo6,sojo6,1,1,0,1,2,0,0.010461701
2276692175,Abukythum,Abukythum,1,2,0,2,2,1,0.043853294
2506363110,StatoIslamico,StatoIslamico,1,2,0,2,2,0.5,0.059396452
955224295,5h4bs,5h4bs,1,1,0,1,2,0,0.010461701
1127977328,UsoulAl_Emaan,UsoulAl_Emaan,1,1,0,1,2,0,0.010461701
1921368811,Somali_AlBattar,Somali_AlBattar,1,1,0,1,2,0,0.010461701
488247721,1986aql,1986aql,1,1,0,1,2,0,0.010461701
91230665,Akhfuad,Akhfuad,1,1,1,2,2,0,0.010461701
1872368130,amoaiiad1,amoaiiad1,1,1,0,1,2,0,0.010461701
1101074948,EddeyDanny,EddeyDanny,1,1,0,1,2,0,0.010461701
64000527,AlptekinAkdogan,AlptekinAkdogan,1,1,0,1,2,0,0.010461701
2148635174,nasifahmedmonir,nasifahmedmonir,1,3,0,3,2,0.8333333,0.092788046
2609353277,abdalaziz1141,abdalaziz1141,1,1,0,1,2,0,0.010461701
2215842410,Mahmoud91Mo,Mahmoud91Mo,1,1,0,1,2,0,0.010461701
2587038325,ax863,ax863,1,2,1,3,2,0.5,0.059396452
311693980,Syrian_Eyad,Syrian_Eyad,1,1,0,1,2,0,0.010461701
2449216207,MostakSobhan,MostakSobhan,1,1,0,1,2,0,0.010461701
484610792,TSventon,TSventon,1,1,0,1,2,0,0.010461701
359731951,ajijon_jang,ajijon_jang,1,1,0,1,2,0,0.010461701
354652944,fan4portis,fan4portis,1,1,0,1,2,0,0.010461701
2261357336,jamesking1492,jamesking1492,1,1,0,1,2,0,0.010461701
2388169510,Isa_AlKurdyy,Isa_AlKurdyy,1,1,0,1,2,0,0.010461701
152212296,shania_021,shania_021,1,2,0,2,2,0.5,0.059396452
2340885325,aaboodi831,aaboodi831,1,1,0,1,2,0,0.010461701
357733254,harampolice,harampolice,1,1,1,2,2,0,0.010461701
1703456245,Abu_muhanad101,Abu_muhanad101,1,1,0,1,2,0,0.010461701
250155987,BinttAltheeb,BinttAltheeb,1,1,0,1,2,0,0.010461701
2199819482,zezoo_ze77,zezoo_ze77,1,1,0,1,2,0,0.010461701
880481671,khankakar8,khankakar8,1,1,0,1,2,0,0.010461701
348493198,BabaHilal1,BabaHilal1,1,1,0,1,2,0,0.010461701
807703968,Jod6437Azrul,Jod6437Azrul,1,1,0,1,2,0,0.010461701
176920041,FadahJassem,FadahJassem,1,1,0,1,2,0,0.010461701
961287667,riiiftOon,riiiftOon,1,1,0,1,2,0,0.010461701
2276082601,HssnrM,HssnrM,1,5,0,5,2,0.6,0.153906881
390272547,Bierbuikmodel,Bierbuikmodel,1,1,0,1,2,0,0.010461701
2652378784,gilbert8570,gilbert8570,1,1,0,1,2,0,0.010461701
2476906160,jamaludinali30,jamaludinali30,1,4,0,4,2,0.75,0.117499061
257857245,Hus_BR,Hus_BR,1,1,0,1,2,0,0.010461701
461313792,kronixzz,kronixzz,1,1,0,1,2,0,0.010461701
2283345728,sungsu_cho,sungsu_cho,1,1,0,1,2,0,0.010461701
507451211,AdibZakir,AdibZakir,1,1,0,1,2,0,0.010461701
2230693426,Properpalii,Properpalii,1,1,0,1,2,0,0.010461701
466360154,Ammar_roj,Ammar_roj,1,4,0,4,2,0.75,0.117499061
2717620061,deanislam14,deanislam14,1,1,1,2,2,0,0.010461701
2284722064,Umm_Sadiiq,Umm_Sadiiq,1,2,0,2,2,1,0.043853294
2547685284,AHMED0000000008,AHMED0000000008,1,2,0,2,2,1,0.043853294
2654181306,mariamadam73,mariamadam73,1,1,0,1,2,0,0.010461701
2338232292,faridafree,faridafree,1,2,1,3,2,1,0.043853294
633935849,ronanfitz22,ronanfitz22,1,1,0,1,2,0,0.010461701
1542002695,abooody4u2011,abooody4u2011,1,1,0,1,2,0,0.010461701
288102443,hivaap,hivaap,1,1,0,1,2,0,0.010461701
2363889733,al_babiyah,al_babiyah,1,2,0,2,2,1,0.043853294
1966708825,Mujaddid_Ibn,Mujaddid_Ibn,1,1,0,1,2,0,0.010461701
2817824862,Laiba12Umar,Laiba12Umar,1,1,0,1,2,0,0.010461701
438264607,fayssal2600,fayssal2600,1,1,0,1,2,0,0.010461701
2608568549,islammpic,islammpic,1,1,0,1,2,0,0.010461701
2499418406,MUHAMMETGEYLAN1,MUHAMMETGEYLAN1,1,1,0,1,2,0,0.010461701
228694360,JeVeuxEtreMoi,JeVeuxEtreMoi,1,1,0,1,2,0,0.010461701
2387450281,wildogre_,wildogre_,1,1,0,1,2,0,0.010461701
374774206,GDahhan,GDahhan,1,4,0,4,2,0.5,0.096558292
495851983,norden15,norden15,1,1,0,1,2,0,0.010461701
1083578850,AbdelqadirCesar,AbdelqadirCesar,1,1,0,1,2,0,0.010461701
777198098,Islamic_vids,Islamic_vids,1,1,0,1,2,0,0.010461701
2252708427,wanted_mujahid,wanted_mujahid,1,1,0,1,2,0,0.010461701
2840599134,WhiteblackDeen,WhiteblackDeen,1,1,0,1,2,0,0.010461701
1708006009,Abdullah_COYG,Abdullah_COYG,1,1,0,1,2,0,0.010461701
1150753470,UmmatAlQuraan,UmmatAlQuraan,1,3,0,3,2,0.33333334,0.05467941
1545214688,Shanty701,Shanty701,1,1,0,1,2,0,0.010461701
25139939,matthewcassel,matthewcassel,1,1,0,1,2,0,0.010461701
2703792902,muwahhid10,muwahhid10,1,4,0,4,2,0.5,0.103614162
1893997363,FRashid666,FRashid666,1,1,0,1,2,0,0.010461701
382704479,ossieosman,ossieosman,1,1,0,1,2,0,0.010461701
239016895,yougoodlooking,yougoodlooking,1,1,0,1,2,0,0.010461701
2279021510,fes_brahim,fes_brahim,1,1,0,1,2,0,0.010461701
2784009237,MoHassan92,MoHassan92,1,1,0,1,2,0,0.010461701
2340920360,Zakariy53254927,Zakariy53254927,1,3,0,3,2,0.33333334,0.063166699
17210424,cimbaalplayer,cimbaalplayer,1,1,0,1,2,0,0.010461701
2857016424,abuabdullahzaid,abuabdullahzaid,1,1,0,1,2,0,0.010461701
2826771565,AbuSwalahuddin,AbuSwalahuddin,1,1,0,1,2,0,0.010461701
1186110577,Anwar512Anwar,Anwar512Anwar,1,1,0,1,2,0,0.010461701
24686460,ilanNOS,ilanNOS,1,1,0,1,2,0,0.010461701
2582420767,abuyahia110,abuyahia110,1,1,0,1,2,0,0.010461701
2244418875,abubaka12197998,abubaka12197998,1,2,0,2,2,0.5,0.059396452
2611551555,kurdishtiger1,kurdishtiger1,1,1,0,1,2,0,0.010461701
569711968,allons_y___,allons_y___,1,1,0,1,2,0,0.010461701
46439785,robbertsalome,robbertsalome,1,1,0,1,2,0,0.010461701
145005955,Hamza_ibn_Rasol,Hamza_ibn_Rasol,1,1,0,1,2,0,0.010461701
2472025502,MaxamuudFantast,MaxamuudFantast,1,1,0,1,2,0,0.010461701
527428525,ChandMashaal,ChandMashaal,1,1,0,1,2,0,0.010461701
2772737460,sc1863,sc1863,1,2,0,2,2,0.5,0.059396452
225748519,the_ukht,the_ukht,1,1,0,1,2,0,0.010461701
61808074,Vandaliser,Vandaliser,1,1,0,1,2,0,0.010461701
2536152554,AMuhammad60,AMuhammad60,1,1,0,1,2,0,0.010461701
130326033,Remco_te_Kloese,Remco_te_Kloese,1,1,0,1,2,0,0.010461701
2500927070,DutchSeparatist,DutchSeparatist,1,1,0,1,2,0,0.010461701
2738626156,Seeking_Life_,Seeking_Life_,1,1,0,1,2,0,0.010461701
84483694,Ayse_BetuL,Ayse_BetuL,1,1,0,1,2,0,0.010461701
2777915001,Waadalali213,Waadalali213,1,1,0,1,2,0,0.010461701
567254657,AneesBarbz,AneesBarbz,1,1,0,1,2,0,0.010461701
2197495434,noworryy,noworryy,1,1,0,1,2,0,0.010461701
237674151,knuffeltje1960,knuffeltje1960,1,1,0,1,2,0,0.010461701
2365791925,Midoissa2Issa,Midoissa2Issa,1,1,0,1,2,0,0.010461701
1125326521,ranggafebryandi,ranggafebryandi,1,1,0,1,2,0,0.010461701
2591301386,JuniaziaZia,JuniaziaZia,1,2,0,2,2,0.5,0.059396452
492019494,nd4671,nd4671,1,1,0,1,2,0,0.010461701
2611584808,of_isis,of_isis,1,2,0,2,2,0.5,0.059396452
2239635277,murabittun,murabittun,1,1,0,1,2,0,0.010461701
2369265494,Al_Abdullahh,Al_Abdullahh,1,1,0,1,2,0,0.010461701
131506119,lalemesut,lalemesut,1,2,0,2,2,0.5,0.059396452
2270928871,Abu_Khaild101,Abu_Khaild101,1,1,0,1,2,0,0.010461701
2585108472,ssabir233,ssabir233,1,1,0,1,2,0,0.010461701
1886068736,IPacInstitute,IPacInstitute,1,1,0,1,2,0,0.010461701
2688098378,_IbneHussain,_IbneHussain,1,1,0,1,2,0,0.010461701
2795675813,WarisWari,WarisWari,1,1,0,1,2,0,0.010461701
626368703,_Muslimah_T,_Muslimah_T,1,1,0,1,2,0,0.010461701
2183864525,MuawiyaIASufian,MuawiyaIASufian,1,0,2,2,2,0.5,0
361210161,Fajar_Setiawann,Fajar_Setiawann,1,1,0,1,2,0,0.010461701
585703760,Maksudalam02,Maksudalam02,1,1,0,1,2,0,0.010461701
2740298074,aboalghreeb911,aboalghreeb911,1,2,0,2,2,0.5,0.059396452
2739675501,jillo2mohammed,jillo2mohammed,1,1,0,1,2,0,0.010461701
2263392648,UnkownKw,UnkownKw,1,1,0,1,2,0,0.010461701
368189871,Ronin_timur,Ronin_timur,1,1,0,1,2,0,0.010461701
2454102493,UmmuOmmar,UmmuOmmar,1,2,0,2,2,1,0.043853294
2691965470,chahidbenahmed,chahidbenahmed,1,1,0,1,2,0,0.010461701
2408292987,fehda_malik,fehda_malik,1,1,0,1,2,0,0.010461701
315169557,robertverkaik1,robertverkaik1,1,3,0,3,2,0.33333334,0.063166699
2754916463,Heliolatrous32,Heliolatrous32,1,1,0,1,2,0,0.010461701
2608833183,AboHero1997,AboHero1997,1,1,0,1,2,0,0.010461701
2253759228,Tseeker99,Tseeker99,1,2,0,2,2,1,0.043853294
2766152455,ishinecleaning1,ishinecleaning1,1,1,0,1,2,0,0.010461701
1732092684,delana251,delana251,1,1,0,1,2,0,0.010461701
193988063,daniel_ahmed,daniel_ahmed,1,2,0,2,2,0.5,0.059396452
627975112,Dralamoudy2012,Dralamoudy2012,1,2,0,2,2,1,0.043853294
1737368558,The_ordinary2,The_ordinary2,1,1,0,1,2,0,0.010461701
1900848134,sixskis,sixskis,1,1,0,1,2,0,0.010461701
2341807116,muneerdxb10,muneerdxb10,1,1,0,1,2,0,0.010461701
337716264,AfnanMalizie,AfnanMalizie,1,1,0,1,2,0,0.010461701
2593956984,kafeelansari70,kafeelansari70,1,3,0,3,2,0.8333333,0.092788046
1869816985,faiz_679,faiz_679,1,1,0,1,2,0,0.010461701
2495489178,oumusama,oumusama,1,2,0,2,2,0.5,0.059396452
2548180141,95_husam,95_husam,1,1,0,1,2,0,0.010461701
2504533191,JundAlah,JundAlah,1,3,0,3,2,0.16666667,0.025058063
2743543005,appelflapje666,appelflapje666,1,1,0,1,2,0,0.010461701
257565961,maanmiinka,maanmiinka,1,1,0,1,2,0,0.010461701
719725855,HAliGesey,HAliGesey,1,1,0,1,2,0,0.010461701
1844979098,OCasawi,OCasawi,1,1,0,1,2,0,0.010461701
2770019761,iwan29078905,iwan29078905,1,2,0,2,2,0.5,0.059396452
2237670840,khilafahrevival,khilafahrevival,1,1,0,1,2,0,0.010461701
2684003811,XxxaAbdullah,XxxaAbdullah,1,1,0,1,2,0,0.010461701
2447975910,osama911911,osama911911,1,1,0,1,2,0,0.010461701
2492245574,MujahidZulo,MujahidZulo,1,1,0,1,2,0,0.010461701
1599317635,Abo_mo3az22,Abo_mo3az22,1,1,0,1,2,0,0.010461701
2331584135,mustafa40218575,mustafa40218575,1,1,0,1,2,0,0.010461701
1486300808,fa9aheni,fa9aheni,1,1,0,1,2,0,0.010461701
974104237,HermanBosch65,HermanBosch65,1,1,0,1,2,0,0.010461701
2354292417,ahmad_jaaved,ahmad_jaaved,1,1,0,1,2,0,0.010461701
2301437643,Kylerufc89,Kylerufc89,1,1,0,1,2,0,0.010461701
206153434,idunnoed,idunnoed,1,1,0,1,2,0,0.010461701
2396464956,rakhadandi,rakhadandi,1,2,0,2,2,0,0.014231947
2708875070,jundullaah90,jundullaah90,1,1,0,1,2,0,0.010461701
2769168248,Juhani12Juhani,Juhani12Juhani,1,1,0,1,2,0,0.010461701
354199534,ali_faseeh,ali_faseeh,1,1,0,1,2,0,0.010461701
446965769,mojobaghdad,mojobaghdad,1,1,0,1,2,0,0.010461701
64399387,anipcute,anipcute,1,1,0,1,2,0,0.010461701
583477282,aadila_01,aadila_01,1,1,0,1,2,0,0.010461701
95856702,JulienHolland,JulienHolland,1,1,0,1,2,0,0.010461701
455321690,ibrahim_tayyab,ibrahim_tayyab,1,3,0,3,2,0.33333334,0.063166699
22259810,nikejo,nikejo,1,2,0,2,2,0,0.021287817
2767071341,khalidelbadr19,khalidelbadr19,1,2,0,2,2,0.5,0.059396452
2485987448,kkk_nnn_tn,kkk_nnn_tn,1,1,0,1,2,0,0.010461701
866986154,__MasrawY,__MasrawY,1,2,0,2,2,0.5,0.035172715
2784012506,altanjawia,altanjawia,1,1,0,1,2,0,0.010461701
2432608481,Al7aFeeD_,Al7aFeeD_,1,1,0,1,2,0,0.010461701
2274306290,OfMujahid,OfMujahid,1,1,0,1,2,0,0.010461701
2759829751,01fajaruddin,01fajaruddin,1,1,0,1,2,0,0.010461701
1935263454,1_4Imam,1_4Imam,1,1,0,1,2,0,0.010461701
2288213054,independtnews,independtnews,1,2,0,2,2,0.5,0.059396452
306391606,Zulfa2000,Zulfa2000,1,2,0,2,2,1,0.043853294
2676238906,Ousama_Ibn_Zayd,Ousama_Ibn_Zayd,1,2,0,2,2,0.5,0.059396452
2571938437,MuslimFlower199,MuslimFlower199,1,3,1,4,2,0.8333333,0.092788046
257862309,meherun_,meherun_,1,2,0,2,2,1,0.043853294
878586541,EastMukaramali,EastMukaramali,1,1,0,1,2,0,0.010461701
2813413154,_AlBritaaniyya,_AlBritaaniyya,1,1,0,1,2,0,0.010461701
2650614548,oluwalodelade,oluwalodelade,1,1,0,1,2,0,0.010461701
2265099035,ibnauf6,ibnauf6,1,1,0,1,2,0,0.010461701
1704373050,salehc57,salehc57,1,1,0,1,2,0,0.010461701
1711549260,IhtikamuddinD,IhtikamuddinD,1,2,0,2,2,1,0.043853294
2752719696,oneone00oneone,oneone00oneone,1,1,0,1,2,0,0.010461701
2296818513,syria12219,syria12219,1,1,0,1,2,0,0.010461701
2302618526,Gaziyah,Gaziyah,1,1,0,1,2,0,0.010461701
218606507,ekstinkt,ekstinkt,1,1,0,1,2,0,0.010461701
2298162102,lgehad12,lgehad12,1,1,0,1,2,0,0.010461701
271363040,zomaarmengen,zomaarmengen,1,1,0,1,2,0,0.010461701
265432044,Ishmail143,Ishmail143,1,1,0,1,2,0,0.010461701
26455071,safwan_sifu,safwan_sifu,1,2,0,2,2,1,0.043853294
2406067247,abu_nuhh,abu_nuhh,1,1,0,1,2,0,0.010461701
2280467516,bebnewstweets,bebnewstweets,1,1,0,1,2,0,0.010461701
1514056765,Ibrashuhus2013,Ibrashuhus2013,1,1,0,1,2,0,0.010461701
2729290825,banerons,banerons,1,1,0,1,2,0,0.010461701
1074146400,hamdigodey,hamdigodey,1,1,0,1,2,0,0.010461701
1041377102,ekunmeranime,ekunmeranime,1,1,0,1,2,0,0.010461701
2298358910,taur965b,taur965b,1,1,0,1,2,0,0.010461701
2848631953,mhbllghad2,mhbllghad2,1,2,0,2,2,1,0.043853294
2617486573,ranamasud9910,ranamasud9910,1,1,0,1,2,0,0.010461701
2749050189,seferryilmaz,seferryilmaz,1,1,0,1,2,0,0.010461701
2676862313,IbnHuneyf,IbnHuneyf,1,3,0,3,2,0.33333334,0.063166699
2310024559,Brown75Natalie,Brown75Natalie,1,1,0,1,2,0,0.010461701
2417962369,tomash_lue,tomash_lue,1,1,0,1,2,0,0.010461701
1128574346,130Karim,130Karim,1,2,0,2,2,0,0.014231947
2186259855,abu_zayd_sham,abu_zayd_sham,1,1,0,1,2,0,0.010461701
2693788234,fuzayilm,fuzayilm,1,1,0,1,2,0,0.010461701
240594415,ariripaldi,ariripaldi,1,1,0,1,2,0,0.010461701
171421190,atennan,atennan,1,1,0,1,2,0,0.010461701
2440965657,mmtt660003,mmtt660003,1,1,0,1,2,0,0.010461701
2154704410,AbuMansour02,AbuMansour02,1,1,0,1,2,0,0.010461701
2575445576,RashidunMujahid,RashidunMujahid,1,1,0,1,2,0,0.010461701
2289413774,jihad_iz,jihad_iz,1,1,0,1,2,0,0.010461701
234925810,Majstar7,Majstar7,1,1,2,3,2,0.5,0.010461701
2244095747,Abuzarguffari2,Abuzarguffari2,1,1,0,1,2,0,0.010461701
2767990583,A_Abd_Allah,A_Abd_Allah,1,1,0,1,2,0,0.010461701
214085527,abuahmedalnajdi,abuahmedalnajdi,1,1,0,1,2,0,0.010461701
2367270814,hassannaseerltd,hassannaseerltd,1,1,0,1,2,0,0.010461701
1662168996,abu_haniyah,abu_haniyah,1,1,0,1,2,0,0.010461701
2754682184,muavia2014,muavia2014,1,1,0,1,2,0,0.010461701
2496966608,hanouna9503,hanouna9503,1,1,0,1,2,0,0.010461701
485961685,alaemejdoub,alaemejdoub,1,1,0,1,2,0,0.010461701
342601720,LeBronJames,LeBronJames,1,1,0,1,2,0,0.010461701
2758750242,Fryater,Fryater,1,1,0,1,2,0,0.010461701
2766483541,emwibro,emwibro,1,1,0,1,2,0,0.010461701
1609347175,historyiskewl,historyiskewl,1,1,0,1,2,0,0.010461701
2261627580,AudePariiisNYC,AudePariiisNYC,1,1,0,1,2,0,0.010461701
734376108,EfeCeylan1274,EfeCeylan1274,1,2,0,2,2,0.5,0.059396452
2597007536,trndrv,trndrv,1,1,0,1,2,0,0.010461701
179581118,ibrocan2007,ibrocan2007,1,1,0,1,2,0,0.010461701
832811215,proffessaar,proffessaar,1,1,0,1,2,0,0.010461701
2395549926,tedua12345,tedua12345,1,1,0,1,2,0,0.010461701
605303041,Razaq2Razzaq,Razaq2Razzaq,1,1,0,1,2,0,0.010461701
1917989144,hugoreitsma,hugoreitsma,1,1,0,1,2,0,0.010461701
2702389563,shahadatacca,shahadatacca,1,1,0,1,2,0,0.010461701
1923199327,AYaassin,AYaassin,1,1,0,1,2,0,0.010461701
2783283265,AbuTakfear,AbuTakfear,1,1,0,1,2,0,0.010461701
1884434826,abdulkadirsen2,abdulkadirsen2,1,1,0,1,2,0,0.010461701
2289578396,ao_072,ao_072,1,1,0,1,2,0,0.010461701
257176305,stuucie,stuucie,1,1,0,1,2,0,0.010461701
2413310472,UmmZubayr000,UmmZubayr000,1,1,0,1,2,0,0.010461701
2566861352,muneernk03,muneernk03,1,1,0,1,2,0,0.010461701
2522100296,inamafridi87,inamafridi87,1,1,0,1,2,0,0.010461701
163099289,CihannnnO,CihannnnO,1,1,0,1,2,0,0.010461701
294499006,TehPlazmon,TehPlazmon,1,1,0,1,2,0,0.010461701
2763010759,jdjfhfhug2,jdjfhfhug2,1,2,0,2,2,0.5,0.035172715
2611491538,kutuzblitz,kutuzblitz,1,2,1,3,2,0.5,0.059396452
2237281030,Raza18usRaza,Raza18usRaza,1,1,0,1,2,0,0.010461701
10924872,leojacket,leojacket,1,1,0,1,2,0,0.010461701
2517545809,Islam01I,Islam01I,1,1,0,1,2,0,0.010461701
2785456980,TheDataAP,TheDataAP,1,1,0,1,2,0,0.010461701
2298262483,AbuHamzaYahya,AbuHamzaYahya,1,2,0,2,2,1,0.043853294
1451111450,aqqumer,aqqumer,1,1,0,1,2,0,0.010461701
172209213,zaahidhu,zaahidhu,1,1,0,1,2,0,0.010461701
233124943,Opticaly84,Opticaly84,1,3,0,3,2,0.6666667,0.084107467
75969641,Ekermawi,Ekermawi,1,1,0,1,2,0,0.010461701
2697475214,obeid187,obeid187,1,2,0,2,2,0.5,0.059396452
737916048,adnaanOFF,adnaanOFF,1,1,0,1,2,0,0.010461701
2233021640,erwinsofwan1,erwinsofwan1,1,1,0,1,2,0,0.010461701
581186774,asghanchi,asghanchi,1,1,0,1,2,0,0.010461701
1421849833,nouriman10,nouriman10,1,1,0,1,2,0,0.010461701
2214442231,ns45678,ns45678,1,2,0,2,2,1,0.043853294
2722739478,ISIS_BAQIAH1,ISIS_BAQIAH1,1,1,0,1,2,0,0.010461701
2828383608,abousalmane93,abousalmane93,1,1,0,1,2,0,0.010461701
2233251209,ibnHamdan2,ibnHamdan2,1,1,0,1,2,0,0.010461701
2371204501,sitizahra1704,sitizahra1704,1,1,0,1,2,0,0.010461701
22361573,niet,niet,1,1,0,1,2,0,0.010461701
2589996528,ShaamAlMubarak,ShaamAlMubarak,1,1,0,1,2,0,0.010461701
2726016502,34Moskof,34Moskof,1,1,0,1,2,0,0.010461701
306492933,IbnMuhammed3,IbnMuhammed3,1,1,0,1,2,0,0.010461701
2421110282,MujagaibnBalkan,MujagaibnBalkan,1,1,0,1,2,0,0.010461701
2540975655,Abu_Sarah_farsi,Abu_Sarah_farsi,1,1,0,1,2,0,0.010461701
788772397,AamilNachan,AamilNachan,1,2,0,2,2,0.5,0.059396452
1553643054,IslamicPakTube,IslamicPakTube,1,1,0,1,2,0,0.010461701
2342205003,OmolabWale,OmolabWale,1,2,0,2,2,1,0.043853294
1243821674,khalidassad2,khalidassad2,1,1,0,1,2,0,0.010461701
1686845077,xox_saleha,xox_saleha,1,1,0,1,2,0,0.010461701
1196308141,ISLAM_Beginning,ISLAM_Beginning,1,1,0,1,2,0,0.010461701
85997348,EshHathaKhara,EshHathaKhara,1,1,0,1,2,0,0.010461701
456177483,ImDown4wat_ever,ImDown4wat_ever,1,1,0,1,2,0,0.010461701
1968682830,rkiki88,rkiki88,1,1,0,1,2,0,0.010461701
1880307554,onthatpath3,onthatpath3,1,57,1501,1558,2,7.87E-04,0.239479503
2367338345,ABO_SOHAYB_,ABO_SOHAYB_,1,2,0,2,2,0.5,0.059396452
2493364099,saq811,saq811,1,1,0,1,2,0,0.010461701
1619539860,v1pmuslim,v1pmuslim,1,1,0,1,2,0,0.010461701
112703470,shivmalik,shivmalik,1,2,0,2,2,0,0.014231947
2381887480,AbuHamzaAlIrhab,AbuHamzaAlIrhab,1,1,0,1,2,0,0.010461701
2214541326,1Glenn25,1Glenn25,1,1,0,1,2,0,0.010461701
1844197406,layth_10,layth_10,1,2,0,2,2,0.5,0.059396452
1640282148,Ummammara,Ummammara,1,2,0,2,2,0.5,0.059396452
140425264,Abu_Mumtaz_,Abu_Mumtaz_,1,1,0,1,2,0,0.010461701
1269807156,abusafiya11,abusafiya11,1,1,0,1,2,0,0.010461701
252524606,AdamGnych,AdamGnych,1,1,0,1,2,0,0.010461701
1014052932,M2013Zid,M2013Zid,1,1,0,1,2,0,0.010461701
2261137491,sultana68902613,sultana68902613,1,1,0,1,2,0,0.010461701
2430253210,Aak30Al,Aak30Al,1,1,0,1,2,0,0.010461701
481812167,huzefa94,huzefa94,1,2,0,2,2,1,0.043853294
428849429,ANRosli,ANRosli,1,1,0,1,2,0,0.010461701
612645142,xxl_yy,xxl_yy,1,1,0,1,2,0,0.010461701
45365530,Hanib4L,Hanib4L,1,1,0,1,2,0,0.010461701
967096614,zachopkins,zachopkins,1,1,0,1,2,0,0.010461701
555465031,Walid13268272,Walid13268272,1,1,0,1,2,0,0.010461701
2792012135,Emre__63,Emre__63,1,1,0,1,2,0,0.010461701
2567387564,OporajitaRounak,OporajitaRounak,1,1,0,1,2,0,0.010461701
1959639474,jamw777,jamw777,1,2,0,2,2,0.5,0.059396452
2355280334,ZaR8aWi,ZaR8aWi,1,2,0,2,2,1,0.043853294
1318763060,BordoMaviLovers,BordoMaviLovers,1,2,0,2,2,1,0.043853294
2230204990,AbuTaymiyyah,AbuTaymiyyah,1,1,0,1,2,0,0.010461701
290536051,annapodungge,annapodungge,1,2,0,2,2,0.5,0.059396452
1622850187,fisabilillah315,fisabilillah315,1,1,0,1,2,0,0.010461701
44022426,Umm_Usamah,Umm_Usamah,1,1,0,1,2,0,0.010461701
312543689,GijsUtrecht,GijsUtrecht,1,1,0,1,2,0,0.010461701
15317729,romee,romee,1,1,0,1,2,0,0.010461701
2302163706,Abu7Alaina,Abu7Alaina,1,2,0,2,2,1,0.043853294
57096983,DurtKobane,DurtKobane,1,1,0,1,2,0,0.010461701
248138204,carlavanderwal,carlavanderwal,1,1,0,1,2,0,0.010461701
2262448985,EbuAmir,EbuAmir,1,1,0,1,2,0,0.010461701
2201205607,alfedaaee,alfedaaee,1,1,0,1,2,0,0.010461701
2288892785,abumujahidalpap,abumujahidalpap,1,1,0,1,2,0,0.010461701
2841033632,RanjitZain,RanjitZain,1,1,0,1,2,0,0.010461701
2716482522,Beliye_Kolgotky,Beliye_Kolgotky,1,1,0,1,2,0,0.010461701
525122624,yammama2,yammama2,1,2,0,2,2,0.5,0.059396452
343620724,Daniel_Abdullah,Daniel_Abdullah,1,2,1,3,2,0.8333333,0.043853294
1517141114,moheboal5air,moheboal5air,1,1,0,1,2,0,0.010461701
2599140482,KhalidIbnOmar11,KhalidIbnOmar11,1,2,0,2,2,1,0.043853294
2281716968,abumohammad9011,abumohammad9011,1,1,0,1,2,0,0.010461701
49724677,sevketzaim,sevketzaim,1,1,0,1,2,0,0.010461701
1430469919,mmohsin313,mmohsin313,1,2,0,2,2,1,0.043853294
2738306344,almihdar_m,almihdar_m,1,4,0,4,2,0.75,0.117499061
497171788,latiphh,latiphh,1,1,0,1,2,0,0.010461701
1661484398,kkwv,kkwv,1,2,0,2,2,1,0.043853294
212385162,castadivanorma,castadivanorma,1,1,0,1,2,0,0.010461701
941014423,yasariqbal9,yasariqbal9,1,2,0,2,2,0.5,0.059396452
20331984,mattizz,mattizz,1,1,0,1,2,0,0.010461701
1044954588,RASIDIHILAFET,RASIDIHILAFET,1,1,0,1,2,0,0.010461701
2715565545,nakmathe,nakmathe,1,1,0,1,2,0,0.010461701
434814471,EbuJahja,EbuJahja,1,1,0,1,2,0,0.010461701
553565798,FreiMann88,FreiMann88,1,1,0,1,2,0,0.010461701
2761473639,Salafi_Snitch,Salafi_Snitch,1,1,0,1,2,0,0.010461701
2378677910,rrohim36,rrohim36,1,1,0,1,2,0,0.010461701
2603597503,umalfaroop,umalfaroop,1,2,0,2,2,0.5,0.059396452
2565092647,PiccolosEgg,PiccolosEgg,1,1,0,1,2,0,0.010461701
51822354,aliaallana,aliaallana,1,1,0,1,2,0,0.010461701
230637384,delawarecoast,delawarecoast,1,1,0,1,2,0,0.010461701
1101742002,asabbadi,asabbadi,1,1,0,1,2,0,0.010461701
2792800309,_bintsham,_bintsham,1,3,0,3,2,0.6666667,0.068564309
2580987979,AnonMuslim123,AnonMuslim123,1,2,0,2,2,1,0.043853294
574046292,ahmedbenmouhame,ahmedbenmouhame,1,1,0,1,2,0,0.010461701
2751119470,abumuammadsham,abumuammadsham,1,2,0,2,2,0.5,0.059396452
21479560,maxlerou,maxlerou,1,1,0,1,2,0,0.010461701
1860911252,Xedze_Dersimi,Xedze_Dersimi,1,1,0,1,2,0,0.010461701
112443543,gjanni,gjanni,1,1,0,1,2,0,0.010461701
2601631922,anonymous_1999_,anonymous_1999_,1,3,0,3,2,0.8333333,0.092788046
193249551,bartwillemsgent,bartwillemsgent,1,1,0,1,2,0,0.010461701
2311504190,Ummukhalid4,Ummukhalid4,1,1,0,1,2,0,0.010461701
2834284951,chanzeb_t,chanzeb_t,1,1,0,1,2,0,0.010461701
1383383473,sevislam,sevislam,1,2,0,2,2,1,0.043853294
2156216804,WeAreReturning,WeAreReturning,1,3,1,4,2,0.8333333,0.092788046
217235985,Samiiirrr94,Samiiirrr94,1,2,1,3,2,0.5,0.059396452
19120675,jbugel,jbugel,1,1,0,1,2,0,0.010461701
824885952,ptbergmans,ptbergmans,1,1,0,1,2,0,0.010461701
1546306303,blockdesign75,blockdesign75,1,1,0,1,2,0,0.010461701
2734506767,363333344e5c492,363333344e5c492,1,3,0,3,2,0.33333334,0.063166699
104186659,javedbetab,javedbetab,1,2,0,2,2,0.5,0.059396452
2403058474,qaatil23,qaatil23,1,1,2,3,2,0.5,0.010461701
1470645044,senjenkhilafa,senjenkhilafa,1,1,0,1,2,0,0.010461701
1196180288,AbuBaseerAlmani,AbuBaseerAlmani,1,1,0,1,2,0,0.010461701
352961500,Chilipalmer2,Chilipalmer2,1,1,0,1,2,0,0.010461701
1158464491,HassanAlkatani,HassanAlkatani,1,1,0,1,2,0,0.010461701
1476550826,usdr323Old,usdr323Old,1,2,0,2,2,1,0.043853294
2457552012,abdulalmuj,abdulalmuj,1,2,0,2,2,1,0.043853294
435293038,mohamedmuhajir,mohamedmuhajir,1,1,0,1,2,0,0.010461701
2608612653,hiishahmed191,hiishahmed191,1,1,0,1,2,0,0.010461701
257934669,TheoPadnos,TheoPadnos,1,1,0,1,2,0,0.010461701
615466387,shukriali90,shukriali90,1,1,0,1,2,0,0.010461701
772392360,Yankee_Ram,Yankee_Ram,1,1,0,1,2,0,0.010461701
50841069,pedrvs,pedrvs,1,1,0,1,2,0,0.010461701
1696024092,hamsul_alhaq,hamsul_alhaq,1,1,0,1,2,0,0.010461701
2634663481,ariane_britania,ariane_britania,1,3,2,5,2,0.8333333,0.092788046
595805793,3abiratSabeel,3abiratSabeel,1,3,0,3,2,0.6666667,0.084107467
1040829372,yusufboke76,yusufboke76,1,1,0,1,2,0,0.010461701
2290370185,FMahmudBD,FMahmudBD,1,1,0,1,2,0,0.010461701
2369668747,sayahatqi1982,sayahatqi1982,1,1,0,1,2,0,0.010461701
246302422,Hamadaa77,Hamadaa77,1,1,0,1,2,0,0.010461701
125748988,AbdullahAkbar05,AbdullahAkbar05,1,1,0,1,2,0,0.010461701
1234356012,sigit_g_biru,sigit_g_biru,1,1,0,1,2,0,0.010461701
462505777,Ibntashfin1,Ibntashfin1,1,1,0,1,2,0,0.010461701
2242889534,Marwan52Mahdi,Marwan52Mahdi,1,4,0,4,2,0.75,0.117499061
241682338,swatzutphen,swatzutphen,1,1,0,1,2,0,0.010461701
2736900037,mideast_watch,mideast_watch,1,3,0,3,2,0.33333334,0.04762354
2354956236,faizal201180,faizal201180,1,1,0,1,2,0,0.010461701
244140007,alkhemal,alkhemal,1,3,0,3,2,0.8333333,0.092788046
2437728266,JosephLaurel78,JosephLaurel78,1,2,0,2,2,0.5,0.059396452
1392910682,infinitedimensi,infinitedimensi,1,1,0,1,2,0,0.010461701
342952966,khair_kchr,khair_kchr,1,1,0,1,2,0,0.010461701
2217166934,mrsyedzakirmuha,mrsyedzakirmuha,1,1,0,1,2,0,0.010461701
50284642,coenterwolbeek,coenterwolbeek,1,1,0,1,2,0,0.010461701
2214414450,zahir_kader,zahir_kader,1,1,0,1,2,0,0.010461701
1293600919,Qaziyasir8,Qaziyasir8,1,1,0,1,2,0,0.010461701
829343966,nabihbulos,nabihbulos,1,1,0,1,2,0,0.010461701
2560739660,dectorlove2013,dectorlove2013,1,1,0,1,2,0,0.010461701
2512898396,rasheedmalek5,rasheedmalek5,1,1,0,1,2,0,0.010461701
2797587514,dighami,dighami,1,1,0,1,2,0,0.010461701
2517518711,FitneKiran,FitneKiran,1,1,0,1,2,0,0.010461701
2193475972,hanzada2014,hanzada2014,1,1,0,1,2,0,0.010461701
212650442,jnr_beardo,jnr_beardo,1,1,0,1,2,0,0.010461701
2206943708,J_activist,J_activist,1,2,1,3,2,1,0.043853294
2253179412,Muwahedah,Muwahedah,1,1,0,1,2,0,0.010461701
741132829,julesjibril,julesjibril,1,1,0,1,2,0,0.010461701
2258586170,rimaliamagi,rimaliamagi,1,1,0,1,2,0,0.010461701
2203961917,Alpatih09,Alpatih09,1,1,0,1,2,0,0.010461701
2505460374,DeactivateKB,DeactivateKB,1,3,0,3,2,0.8333333,0.092788046
27970210,pieternanninga,pieternanninga,1,1,0,1,2,0,0.010461701
413649591,MAOrorox,MAOrorox,1,1,0,1,2,0,0.010461701
2394606290,LawlietAde,LawlietAde,1,1,0,1,2,0,0.010461701
374491915,zdeloyola,zdeloyola,1,1,0,1,2,0,0.010461701
155765522,CumiCola,CumiCola,1,2,0,2,2,0,0.021287817
245271704,abou2rab,abou2rab,1,1,0,1,2,0,0.010461701
2304986030,rayattawheed,rayattawheed,1,1,0,1,2,0,0.010461701
1701530556,ssgmailshowkat,ssgmailshowkat,1,1,0,1,2,0,0.010461701
153209817,abd_arrazzaq,abd_arrazzaq,1,1,0,1,2,0,0.010461701
583224296,VermeulenGerrie,VermeulenGerrie,1,1,0,1,2,0,0.010461701
2589871122,AbuHamzaSE,AbuHamzaSE,1,3,1,4,2,0.8333333,0.092788046
709282859,UmmMuhammad57,UmmMuhammad57,1,1,0,1,2,0,0.010461701
2661403811,AbuHaarith95,AbuHaarith95,1,1,0,1,2,0,0.010461701
1291242660,Skelet0nius,Skelet0nius,1,3,0,3,2,0.8333333,0.092788046
2475478202,nyhidua,nyhidua,1,1,0,1,2,0,0.010461701
74894548,VancouverExpat,VancouverExpat,1,1,0,1,2,0,0.010461701
2392837333,Ibrahim64686812,Ibrahim64686812,1,2,0,2,2,1,0.043853294
2606976249,ghariba_khadija,ghariba_khadija,1,3,0,3,2,0.8333333,0.092788046
316394777,secmensapka,secmensapka,1,1,0,1,2,0,0.010461701
217533726,tauq88,tauq88,1,1,0,1,2,0,0.010461701
2459847986,murator93389601,murator93389601,1,1,0,1,2,0,0.010461701
746704219,akhadam77,akhadam77,1,1,0,1,2,0,0.010461701
957762920,Ahmed53267399,Ahmed53267399,1,1,0,1,2,0,0.010461701
2707803540,Abu_Mos3ab11,Abu_Mos3ab11,1,1,0,1,2,0,0.010461701
43863522,mecomuhammad,mecomuhammad,1,1,0,1,2,0,0.010461701
33377787,riantizionist,riantizionist,1,1,0,1,2,0,0.010461701
617041515,islameconomics,islameconomics,1,1,1,2,2,0.5,0.010461701
1636388580,Samen08,Samen08,1,2,0,2,2,1,0.043853294
1112428273,Mustihindawi,Mustihindawi,1,1,0,1,2,0,0.010461701
2541604625,basajewsultan,basajewsultan,1,1,0,1,2,0,0.010461701
2696105778,a152906918b1492,a152906918b1492,1,1,0,1,2,0,0.010461701
2435796798,ummekhattab,ummekhattab,1,1,0,1,2,0,0.010461701
700010309,saad5559974,saad5559974,1,1,0,1,2,0,0.010461701
2458013542,sper010,sper010,1,1,0,1,2,0,0.010461701
389762973,mogamba1,mogamba1,1,1,0,1,2,0,0.010461701
2167230461,Sobia345Sobia,Sobia345Sobia,1,1,0,1,2,0,0.010461701
501174288,AshiqeRasul,AshiqeRasul,1,1,0,1,2,0,0.010461701
370888747,kusha33,kusha33,1,3,0,3,2,0.8333333,0.092788046
2429997138,noorface1,noorface1,1,1,0,1,2,0,0.010461701
2176962681,ibnalsalvadori,ibnalsalvadori,1,1,0,1,2,0,0.010461701
2563657907,itsback1920,itsback1920,1,3,0,3,2,0.33333334,0.04762354
62476512,taryuman,taryuman,1,2,0,2,2,0.5,0.059396452
2816528617,AnsarrullaHcom,AnsarrullaHcom,1,4,0,4,2,0.5,0.096558292
2736214263,Sha_Hada,Sha_Hada,1,3,0,3,2,0.33333334,0.063166699
2306494730,abudujana15,abudujana15,1,1,0,1,2,0,0.010461701
590041444,davidpoort,davidpoort,1,1,0,1,2,0,0.010461701
1895944628,habeebalsaab,habeebalsaab,1,1,0,1,2,0,0.010461701
2180174309,TarikBidar,TarikBidar,1,2,0,2,2,0.5,0.059396452
2626069251,swalehali7,swalehali7,1,1,0,1,2,0,0.010461701
1920127561,ameerhasan080,ameerhasan080,1,1,0,1,2,0,0.010461701
1015010120,BinthSaud,BinthSaud,1,3,2,5,2,0.6666667,0.085465435
830590442,halma_ali,halma_ali,1,1,0,1,2,0,0.010461701
2224608135,Akmaldheen119,Akmaldheen119,1,4,0,4,2,0.5,0.096558292
2698073092,Mr_Siddique01,Mr_Siddique01,1,1,0,1,2,0,0.010461701
1426478090,Abdur2010Abdur,Abdur2010Abdur,1,3,0,3,2,0.33333334,0.063166699
2781795344,albajih,albajih,1,1,0,1,2,0,0.010461701
57300046,revolverkl,revolverkl,1,1,1,2,2,0.5,0.010461701
2831209559,ISBlackBanners,ISBlackBanners,1,2,0,2,2,0,0.021287817
2394477684,Base_Iman,Base_Iman,1,1,1,2,2,0.5,0.010461701
2436060293,IslamAssistance,IslamAssistance,1,1,0,1,2,0,0.010461701
2246694035,Abdullah4all6,Abdullah4all6,1,1,0,1,2,0,0.010461701
2371704068,72hurr,72hurr,1,2,0,2,2,1,0.043853294
540857651,aiyssah,aiyssah,1,3,0,3,2,0.8333333,0.092788046
297817567,SamPowers1,SamPowers1,1,1,0,1,2,0,0.010461701
2725631550,allahisagoat,allahisagoat,1,2,0,2,2,0.5,0.059396452
491509311,shafeeq018,shafeeq018,1,2,0,2,2,0,0.014231947
18830928,mohayuleyule,mohayuleyule,1,1,0,1,2,0,0.010461701
2162710104,QitaalNews,QitaalNews,1,1,0,1,2,0,0.010461701
2566641290,AbuKapa,AbuKapa,1,1,0,1,2,0,0.010461701
244045531,AmirFayyad_,AmirFayyad_,1,4,0,4,2,0.16666667,0.049769078
2177816305,AtsuHosp,AtsuHosp,1,1,0,1,2,0,0.010461701
48944883,adhian80,adhian80,1,1,0,1,2,0,0.010461701
2205079290,Aty01,Aty01,1,2,0,2,2,0.5,0.059396452
1856922589,female_bauss,female_bauss,1,1,0,1,2,0,0.010461701
325703535,Hank2X,Hank2X,1,1,0,1,2,0,0.010461701
227760019,ETHIOISLAM,ETHIOISLAM,1,2,0,2,2,0.5,0.059396452
2596362164,bsmlt13,bsmlt13,1,2,0,2,2,0.5,0.059396452
476338111,resistancology,resistancology,1,2,0,2,2,0.5,0.059396452
374167489,DJSlammin,DJSlammin,1,1,0,1,2,0,0.010461701
1890637778,kemencolombia,kemencolombia,1,1,0,1,2,0,0.010461701
1623349250,rehabrade,rehabrade,1,1,0,1,2,0,0.010461701
2579932165,abu_jandal_Dui,abu_jandal_Dui,1,2,0,2,2,0.5,0.059396452
41375788,Peettv,Peettv,1,1,0,1,2,0,0.010461701
2855852088,mamoste55,mamoste55,1,1,0,1,2,0,0.010461701
2769410221,SeloLaz,SeloLaz,1,1,0,1,2,0,0.010461701
218290356,AliMashkour,AliMashkour,1,1,0,1,2,0,0.010461701
290052320,sadiq_sadi,sadiq_sadi,1,1,0,1,2,0,0.010461701
2791102692,epull808,epull808,1,2,0,2,2,0.5,0.059396452
2494028066,BintMoslem,BintMoslem,1,1,0,1,2,0,0.010461701
413915448,alsubaieibrahem,alsubaieibrahem,1,1,0,1,2,0,0.010461701
2734807382,qqbicc,qqbicc,1,1,0,1,2,0,0.010461701
472766809,saleemally,saleemally,1,1,0,1,2,0,0.010461701
444094870,medbino,medbino,1,1,0,1,2,0,0.010461701
2419743162,Miyu999F,Miyu999F,1,3,0,3,2,0.8333333,0.092788046
532502978,irsat_g,irsat_g,1,1,0,1,2,0,0.010461701
2238506067,afridiforn,afridiforn,1,1,0,1,2,0,0.010461701
2654951985,OumMaria,OumMaria,1,1,0,1,2,0,0.010461701
2776888615,jameljan1,jameljan1,1,1,0,1,2,0,0.010461701
2588891718,dealfilondon,dealfilondon,1,1,0,1,2,0,0.010461701
23124586,Evelyn__020,Evelyn__020,1,1,0,1,2,0,0.010461701
1014621294,UrjiiAhmad,UrjiiAhmad,1,1,0,1,2,0,0.010461701
1553783468,Tiny1231,Tiny1231,1,1,0,1,2,0,0.010461701
2415876800,KZarzr,KZarzr,1,1,0,1,2,0,0.010461701
2572704452,safdar_ali333,safdar_ali333,1,1,0,1,2,0,0.010461701
473354036,a_rhidwan,a_rhidwan,1,1,0,1,2,0,0.010461701
1323031357,Y0UNGSTERS_,Y0UNGSTERS_,1,1,0,1,2,0,0.010461701
915626869,WakeTheUmmah,WakeTheUmmah,1,1,0,1,2,0,0.010461701
1441749944,wuji777,wuji777,1,1,0,1,2,0,0.010461701
2744179653,AlqaqaBinamar,AlqaqaBinamar,1,1,0,1,2,0,0.010461701
878566394,SelefMuvahhid,SelefMuvahhid,1,1,0,1,2,0,0.010461701
2674318357,maryamali3333,maryamali3333,1,3,0,3,2,0.8333333,0.092788046
144661608,Eslam_Daoud,Eslam_Daoud,1,1,0,1,2,0,0.010461701
2604874260,AbuYusufHaq,AbuYusufHaq,1,3,0,3,2,0.33333334,0.063166699
1192680660,FotoProspekt,FotoProspekt,1,1,0,1,2,0,0.010461701
1337842928,muttaqun_al,muttaqun_al,1,2,0,2,2,1,0.043853294
51076342,Ivar125,Ivar125,1,1,0,1,2,0,0.010461701
14055980,elcasey,elcasey,1,1,0,1,2,0,0.010461701
2571237938,nl_az,nl_az,1,1,0,1,2,0,0.010461701
2226412850,abdgawi,abdgawi,1,2,0,2,2,0,0.014231947
2752503165,isiscunt,isiscunt,1,1,0,1,2,0,0.010461701
2419809673,amarkhattab,amarkhattab,1,1,0,1,2,0,0.010461701
1136713099,umm_khaleel,umm_khaleel,1,3,0,3,2,0.8333333,0.092788046
2502450574,AbuDennis2,AbuDennis2,1,3,0,3,2,0.8333333,0.092788046
2385829304,ADNENJEBALI,ADNENJEBALI,1,1,0,1,2,0,0.010461701
59858369,zohaibmanna,zohaibmanna,1,1,0,1,2,0,0.010461701
2351259095,h_haouari,h_haouari,1,1,0,1,2,0,0.010461701
224681489,T2T3T4T5,T2T3T4T5,1,1,0,1,2,0,0.010461701
319905331,dawooodx,dawooodx,1,1,0,1,2,0,0.010461701
1676795466,ummusamah,ummusamah,1,1,0,1,2,0,0.010461701
1166794316,shidybengbeng,shidybengbeng,1,1,0,1,2,0,0.010461701
2182143675,harfankhan,harfankhan,1,1,0,1,2,0,0.010461701
2279530195,MujahidMuqtar,MujahidMuqtar,1,1,0,1,2,0,0.010461701
2310297430,HamiImamkhaleed,HamiImamkhaleed,1,1,0,1,2,0,0.010461701
420011739,Fhashmi78,Fhashmi78,1,1,0,1,2,0,0.010461701
2346278649,ummharithaa,ummharithaa,1,1,0,1,2,0,0.010461701
1147428630,MayaFahryedo,MayaFahryedo,1,1,0,1,2,0,0.010461701
964681622,ayshadanis,ayshadanis,1,1,0,1,2,0,0.010461701
2716229544,_gli_gli,_gli_gli,1,2,0,2,2,1,0.043853294
903569341,michelle250807,michelle250807,1,4,0,4,2,0.5,0.113459418
505700308,kattestaart,kattestaart,1,1,0,1,2,0,0.010461701
2546556919,BAKIAA123456,BAKIAA123456,1,1,0,1,2,0,0.010461701
2304630860,AliAdenalSomali,AliAdenalSomali,1,1,0,1,2,0,0.010461701
2354864228,abuabdishakur,abuabdishakur,1,1,0,1,2,0,0.010461701
2729599098,AraEngUrdEtc,AraEngUrdEtc,1,2,0,2,2,0.5,0.059396452
2244647421,wolfsaleh511,wolfsaleh511,1,1,0,1,2,0,0.010461701
2437177512,Ibrahimismails,Ibrahimismails,1,1,0,1,2,0,0.010461701
2284282050,abomos3abe,abomos3abe,1,1,0,1,2,0,0.010461701
1422549266,Isoffiz,Isoffiz,1,2,0,2,2,0.5,0.059396452
2287329576,dwemerthrall,dwemerthrall,1,1,0,1,2,0,0.010461701
2510741805,dawla_supporter,dawla_supporter,1,1,0,1,2,0,0.010461701
976314672,heshamelaziry1,heshamelaziry1,1,1,0,1,2,0,0.010461701
2333663563,syedsuhail1991,syedsuhail1991,1,2,0,2,2,0.5,0.059396452
2317541721,FatimaKanada85,FatimaKanada85,1,1,0,1,2,0,0.010461701
1581736298,4nd4lus,4nd4lus,1,2,0,2,2,0.5,0.059396452
2532794821,SahawatKiller,SahawatKiller,1,2,0,2,2,1,0.043853294
2494521862,abuahmed0708,abuahmed0708,1,1,0,1,2,0,0.010461701
2435310103,jihad09876,jihad09876,1,1,0,1,2,0,0.010461701
2378490420,WitzErik,WitzErik,1,2,0,2,2,0.5,0.059396452
2616484430,leeomar8,leeomar8,1,1,0,1,2,0,0.010461701
2289984107,hiishahmed19,hiishahmed19,1,1,0,1,2,0,0.010461701
2458542784,Almojaaaahd,Almojaaaahd,1,1,0,1,2,0,0.010461701
2534171378,ThalabahShan,ThalabahShan,1,5,0,5,2,0.5,0.121269307
2508383067,AjmAsiya,AjmAsiya,1,1,0,1,2,0,0.010461701
2172281749,ArkanFadhil3,ArkanFadhil3,1,2,0,2,2,0,0.014231947
2754306977,GUJA44,GUJA44,1,4,0,4,2,0.33333334,0.073992814
2259870654,hammadcricketer,hammadcricketer,1,1,0,1,2,0,0.010461701
100328453,ultime77,ultime77,1,5,0,5,2,0.35,0.098703829
2258986006,Freelossallday,Freelossallday,1,1,0,1,2,0,0.010461701
447112225,BlessedMuslim10,BlessedMuslim10,1,1,0,1,2,0,0.010461701
2203214906,AmatullahRahmaa,AmatullahRahmaa,1,1,0,1,2,0,0.010461701
2212914240,KufrBitTaghoot,KufrBitTaghoot,1,1,0,1,2,0,0.010461701
2163729485,sasa11071,sasa11071,1,1,0,1,2,0,0.010461701
2261214318,call_mea,call_mea,1,1,0,1,2,0,0.010461701
2380063858,zubayralmani,zubayralmani,1,1,0,1,2,0,0.010461701
2466910405,2ca70ae3595442b,2ca70ae3595442b,1,1,0,1,2,0,0.010461701
20915739,oliverjamesking,oliverjamesking,1,1,0,1,2,0,0.010461701
365585673,cbazanh,cbazanh,1,1,0,1,2,0,0.010461701
2296931604,AyahGarments,AyahGarments,1,1,0,1,2,0,0.010461701
2821252380,HarithHsn,HarithHsn,1,1,0,1,2,0,0.010461701
2603902244,abujamal2129,abujamal2129,1,1,0,1,2,0,0.010461701
2469094727,baxaar74_mm17,baxaar74_mm17,1,1,0,1,2,0,0.010461701
2585027970,DiuAhmed,DiuAhmed,1,3,0,3,2,0.8333333,0.092788046
2588239286,NalineMalla,NalineMalla,1,3,0,3,2,0.8333333,0.092788046
798287348,selimanbengharb,selimanbengharb,1,1,0,1,2,0,0.010461701
2587911707,abu_dawud26,abu_dawud26,1,1,0,1,2,0,0.010461701
2703910458,abualmunzer39,abualmunzer39,1,1,0,1,2,0,0.010461701
1000138339,gjonkerster,gjonkerster,1,1,0,1,2,0,0.010461701
2804573829,umm_lioness,umm_lioness,1,1,0,1,2,0,0.010461701
2706892423,Benladen2014,Benladen2014,1,1,0,1,2,0,0.010461701
430171786,asim1087,asim1087,1,1,0,1,2,0,0.010461701
2794022605,muslimmmmmn,muslimmmmmn,1,3,0,3,2,0.33333334,0.063166699
539092754,WaqasAzimmm,WaqasAzimmm,1,1,0,1,2,0,0.010461701
2711578399,Unkuter45,Unkuter45,1,2,0,2,2,0,0.014231947
185395016,powernpoltics,powernpoltics,1,2,0,2,2,0.5,0.059396452
727050074,ozhanhusnu,ozhanhusnu,1,1,0,1,2,0,0.010461701
257517466,Nafla_alharthi,Nafla_alharthi,1,1,0,1,2,0,0.010461701
2713937834,shofaz128,shofaz128,1,1,0,1,2,0,0.010461701
453797889,MijanauMuhammad,MijanauMuhammad,1,1,0,1,2,0,0.010461701
2827347970,rashidiyadi,rashidiyadi,1,2,0,2,2,0.5,0.059396452
791930953,Lullaa_lady,Lullaa_lady,1,1,0,1,2,0,0.010461701
2646173790,AmmaralSayed64,AmmaralSayed64,1,2,0,2,2,0.5,0.059396452
126249084,BabetinTurkey,BabetinTurkey,1,1,0,1,2,0,0.010461701
2223237281,abumuaadh213,abumuaadh213,1,1,0,1,2,0,0.010461701
2788255922,gjna_soof,gjna_soof,1,1,0,1,2,0,0.010461701
1890052291,rajalinges,rajalinges,1,1,0,1,2,0,0.010461701
205187320,sujimahoni,sujimahoni,1,2,0,2,2,0.5,0.059396452
2383341817,AlAngerwi,AlAngerwi,1,1,0,1,2,0,0.010461701
185592069,Bertine83,Bertine83,1,1,0,1,2,0,0.010461701
618424620,as_somaliyyah,as_somaliyyah,1,1,0,1,2,0,0.010461701
14215526,Pritt,Pritt,1,1,0,1,2,0,0.010461701
2301913471,alshame2011,alshame2011,1,1,0,1,2,0,0.010461701
2564614530,ya_zahra_313,ya_zahra_313,1,2,0,2,2,0.5,0.059396452
476211621,asadatqa,asadatqa,1,1,0,1,2,0,0.010461701
2284513740,khitab_r,khitab_r,1,1,0,1,2,0,0.010461701
2237721045,UmmHumaidAbdu,UmmHumaidAbdu,1,1,0,1,2,0,0.010461701
2633460185,faarisu,faarisu,1,1,0,1,2,0,0.010461701
2457758228,tawhidalanbar,tawhidalanbar,1,2,0,2,2,0.5,0.059396452
2248960557,mohamad79n111,mohamad79n111,1,1,0,1,2,0,0.010461701
2734746232,karo9988m,karo9988m,1,2,0,2,2,0.5,0.059396452
805857967,abukhal7858060,abukhal7858060,1,1,0,1,2,0,0.010461701
701000408,Abuuuuuuuuuu12,Abuuuuuuuuuu12,1,1,0,1,2,0,0.010461701
544795394,AliAlAmriki,AliAlAmriki,1,1,0,1,2,0,0.010461701
2390453041,bccindiaaak,bccindiaaak,1,1,0,1,2,0,0.010461701
626354998,aish0106,aish0106,1,1,0,1,2,0,0.010461701
1946479430,Mujahideen85,Mujahideen85,1,1,0,1,2,0,0.010461701
156035926,Hoesseinsabir,Hoesseinsabir,1,1,0,1,2,0,0.010461701
1588882309,moslem_only,moslem_only,1,1,0,1,2,0,0.010461701
2536074122,abdallahchar,abdallahchar,1,1,0,1,2,0,0.010461701
1508273096,speakfactsMaari,speakfactsMaari,1,2,0,2,2,1,0.043853294
1576627146,UmmMutaasim,UmmMutaasim,1,1,2,3,2,1,0.010461701
223079406,abdul_rd,abdul_rd,1,1,0,1,2,0,0.010461701
163048447,Yunus312,Yunus312,1,1,0,1,2,0,0.010461701
2179918866,Webstarpilot,Webstarpilot,1,1,0,1,2,0,0.010461701
1364880420,habibrehmani313,habibrehmani313,1,1,0,1,2,0,0.010461701
171011117,Amerkhattaab,Amerkhattaab,1,1,0,1,2,0,0.010461701
2445012058,IbnAbudujannah,IbnAbudujannah,1,1,0,1,2,0,0.010461701
2376225299,Bashir433,Bashir433,1,1,0,1,2,0,0.010461701
498035833,KarimaSahla,KarimaSahla,1,1,0,1,2,0,0.010461701
409790318,gfrederikse,gfrederikse,1,1,0,1,2,0,0.010461701
38628596,RizwanPatel,RizwanPatel,1,1,0,1,2,0,0.010461701
8088822,almuhajer,almuhajer,1,1,0,1,2,0,0.010461701
346509877,MrPeacewalker,MrPeacewalker,1,3,0,3,2,0.33333334,0.04762354
2371415365,Tabarakallah24,Tabarakallah24,1,1,0,1,2,0,0.010461701
2393992526,Assadullah_97,Assadullah_97,1,1,0,1,2,0,0.010461701
21261686,treesey,treesey,1,1,0,1,2,0,0.010461701
2273045935,homk2012,homk2012,1,1,0,1,2,0,0.010461701
36924850,AlAyub,AlAyub,1,1,0,1,2,0,0.010461701
2656890348,saeed_J99,saeed_J99,1,1,0,1,2,0,0.010461701
2286906915,_6op3,_6op3,1,1,0,1,2,0,0.010461701
708996658,WePlayFlFA,WePlayFlFA,1,1,0,1,2,0,0.010461701
424046135,blackwood123,blackwood123,1,3,0,3,2,0.6666667,0.084107467
2341760608,hayat1490,hayat1490,1,1,0,1,2,0,0.010461701
2800643720,strangermuslima,strangermuslima,1,1,0,1,2,0,0.010461701
2291199714,Tamerlane313,Tamerlane313,1,1,0,1,2,0,0.010461701
258993958,SamirMbarki,SamirMbarki,1,1,0,1,2,0,0.010461701
2232119146,Aal_ameen,Aal_ameen,1,1,0,1,2,0,0.010461701
714305406,Cibof_Nexzaz,Cibof_Nexzaz,1,1,0,1,2,0,0.010461701
2761387906,not_mi5,not_mi5,1,1,0,1,2,0,0.010461701
84398743,Miskat80,Miskat80,1,2,0,2,2,1,0.043853294
2173497271,MuneebSYD,MuneebSYD,1,1,0,1,2,0,0.010461701
340717498,asfaque_ahmed76,asfaque_ahmed76,1,1,0,1,2,0,0.010461701
2757750719,kingnightking,kingnightking,1,1,0,1,2,0,0.010461701
476213190,abujuwie,abujuwie,1,1,0,1,2,0,0.010461701
153022450,alyxandrajayde,alyxandrajayde,1,1,0,1,2,0,0.010461701
2247454758,fares9904,fares9904,1,1,0,1,2,0,0.010461701
1054273584,aRandomMuslim,aRandomMuslim,1,1,0,1,2,0,0.010461701
2459201593,ibn_rizkydimars,ibn_rizkydimars,1,1,0,1,2,0,0.010461701
2192306262,afaqbeig,afaqbeig,1,1,0,1,2,0,0.010461701
508449465,AsySyaiful01,AsySyaiful01,1,1,0,1,2,0,0.010461701
1463251087,Labeeb_Ibad,Labeeb_Ibad,1,1,0,1,2,0,0.010461701
2306011282,fulanibnfulan,fulanibnfulan,1,2,0,2,2,1,0.06075442
2446127257,old_boy232,old_boy232,1,1,0,1,2,0,0.010461701
1339781286,siraat11,siraat11,1,1,0,1,2,0,0.010461701
2534830286,Sbaa1435,Sbaa1435,1,1,0,1,2,0,0.010461701
2350772466,Matar_Syria,Matar_Syria,1,1,0,1,2,0,0.010461701
607809838,thetourist_01,thetourist_01,1,1,0,1,2,0,0.010461701
465432931,KoshaVonhoff,KoshaVonhoff,1,1,0,1,2,0,0.010461701
2280583542,muslimjihadi2,muslimjihadi2,1,1,0,1,2,0,0.010461701
2773283194,okyan03,okyan03,1,1,0,1,2,0,0.010461701
2562093442,latika_farah,latika_farah,1,1,0,1,2,0,0.010461701
93778329,arabian_island,arabian_island,1,1,0,1,2,0,0.010461701
2832167461,UmmMaria2,UmmMaria2,1,3,0,3,2,0.6666667,0.068564309
2259022394,nasherabe,nasherabe,1,1,0,1,2,0,0.010461701
2411360862,aymancr77,aymancr77,1,1,0,1,2,0,0.010461701
137466651,badmilo08,badmilo08,1,1,0,1,2,0,0.010461701
2192440777,Akh_AbuAzzam,Akh_AbuAzzam,1,1,0,1,2,0,0.010461701
2810835662,mirshadSerendib,mirshadSerendib,1,1,0,1,2,0,0.010461701
2483417825,0Mouhnd,0Mouhnd,1,1,0,1,2,0,0.010461701
705458965,Alexanduhr_,Alexanduhr_,1,1,0,1,2,0,0.010461701
2726818601,DienaresA,DienaresA,1,1,0,1,2,0,0.010461701
374469528,Abu_theJealousy,Abu_theJealousy,1,1,0,1,2,0,0.010461701
344126395,yar_ptc,yar_ptc,1,1,0,1,2,0,0.010461701
501371722,Deen_first,Deen_first,1,1,0,1,2,0,0.010461701
273055231,RodPops,RodPops,1,1,0,1,2,0,0.010461701
865956860,UwaishChoksi,UwaishChoksi,1,1,0,1,2,0,0.010461701
1720415246,As_Somaali,As_Somaali,1,4,0,4,2,0.5,0.096558292
393344058,jamarioMoncife,jamarioMoncife,1,2,0,2,2,1,0.06075442
356775000,lokmanbaba,lokmanbaba,1,1,0,1,2,0,0.010461701
2757424229,AbuHanzalaaa,AbuHanzalaaa,1,1,0,1,2,0,0.010461701
2758407312,rawanisis,rawanisis,1,1,0,1,2,0,0.010461701
155972772,A_Kashmir,A_Kashmir,1,1,0,1,2,0,0.010461701
1272018121,azhari_sahara,azhari_sahara,1,2,0,2,2,0.5,0.059396452
2654136532,abudujana011,abudujana011,1,1,0,1,2,0,0.010461701
2216293681,AbuGharieb,AbuGharieb,1,1,0,1,2,0,0.010461701
1422718273,siraajx,siraajx,1,3,1,4,2,0.8333333,0.092788046
44987732,emvanamsb,emvanamsb,1,1,0,1,2,0,0.010461701
2304636288,Nizam_salafi,Nizam_salafi,1,1,0,1,2,0,0.010461701
2596926906,jameesmco,jameesmco,1,1,0,1,2,0,0.010461701
263845332,musa00530646,musa00530646,1,2,0,2,2,1,0.043853294
2365879774,Abuabdullah09G,Abuabdullah09G,1,1,0,1,2,0,0.010461701
825095654,_rras,_rras,1,1,0,1,2,0,0.010461701
2316990030,stefarge,stefarge,1,2,0,2,2,0.5,0.035172715
357234275,abuyasmine75,abuyasmine75,1,1,0,1,2,0,0.010461701
247821967,IDaddyTaLL,IDaddyTaLL,1,2,1,3,2,0.5,0.059396452
60454582,OscarElNaranjo,OscarElNaranjo,1,3,0,3,2,1,0.094146014
407434936,Striving4Janah,Striving4Janah,1,1,0,1,2,0,0.010461701
272922376,moosje666,moosje666,1,1,0,1,2,0,0.010461701
2812606237,SohainaYu,SohainaYu,1,2,0,2,2,0.5,0.059396452
99579745,Muslimusk,Muslimusk,1,1,0,1,2,0,0.010461701
14251923,sanderknura,sanderknura,1,1,0,1,2,0,0.010461701
726628340,Samir_K10,Samir_K10,1,1,0,1,2,0,0.010461701
2256140364,pastokabli,pastokabli,1,1,0,1,2,0,0.010461701
299563088,Don_Majoni,Don_Majoni,1,1,0,1,2,0,0.010461701
244250747,MahmoudNYC,MahmoudNYC,1,1,0,1,2,0,0.010461701
2213050503,allahu15,allahu15,1,1,0,1,2,0,0.010461701
2555925527,ahadess1,ahadess1,1,3,0,3,2,0.6666667,0.068564309
2486597802,ibnhosen,ibnhosen,1,1,0,1,2,0,0.010461701
1717696730,abuyahya213,abuyahya213,1,1,0,1,2,0,0.010461701
771975552,lunaskooma,lunaskooma,1,1,0,1,2,0,0.010461701
2670930323,gazi_rajib,gazi_rajib,1,3,0,3,2,0.8333333,0.092788046
462715260,SholaKassim,SholaKassim,1,1,0,1,2,0,0.010461701
2283338114,umnour88,umnour88,1,2,0,2,2,1,0.043853294
2200467848,IbnuUmawi,IbnuUmawi,1,1,0,1,2,0,0.010461701
1311898015,Zahed_911,Zahed_911,1,2,0,2,2,0.5,0.059396452
2341698020,PenulisBerhud,PenulisBerhud,1,1,0,1,2,0,0.010461701
2788424172,ummAzzam1,ummAzzam1,1,1,0,1,2,0,0.010461701
898628078,NeelamZulfikar,NeelamZulfikar,1,1,0,1,2,0,0.010461701
486144503,MohmdZaki,MohmdZaki,1,1,0,1,2,0,0.010461701
47938072,FerhatCanp_,FerhatCanp_,1,1,0,1,2,0,0.010461701
575207990,Muhammad_Barro,Muhammad_Barro,1,1,0,1,2,0,0.010461701
1734343225,SatriaTauhid99,SatriaTauhid99,1,1,0,1,2,0,0.010461701
18743053,abdraheim,abdraheim,1,1,0,1,2,0,0.010461701
2788162128,kmoh34506,kmoh34506,1,2,0,2,2,0.5,0.059396452
2190408337,ummatiya_,ummatiya_,1,1,0,1,2,0,0.010461701
2609806059,IdrisSomo,IdrisSomo,1,2,0,2,2,0.5,0.059396452
78314235,bint_muhammad,bint_muhammad,1,1,0,1,2,0,0.010461701
2421881606,abumustafaluit,abumustafaluit,1,1,0,1,2,0,0.010461701
2717219648,levantinewar21,levantinewar21,1,1,0,1,2,0,0.010461701
556661631,1UmmahReminders,1UmmahReminders,1,1,1,2,2,0.5,0.010461701
1700690816,Jawona1942,Jawona1942,1,1,0,1,2,0,0.010461701
61701186,salihamariyam,salihamariyam,1,1,0,1,2,0,0.010461701
2288450501,yusuf4life2001,yusuf4life2001,1,1,0,1,2,0,0.010461701
2505505741,muslimtourism,muslimtourism,1,2,1,3,2,0.5,0.059396452
2743565266,VelenjakT,VelenjakT,1,1,0,1,2,0,0.010461701
345897949,FahadAlfaqih,FahadAlfaqih,1,1,0,1,2,0,0.010461701
2227698655,Deaf2TheInfidel,Deaf2TheInfidel,1,1,0,1,2,0,0.010461701
1573354465,spiker360,spiker360,1,1,0,1,2,0,0.010461701
299924514,General_NDjata,General_NDjata,1,1,0,1,2,0,0.010461701
2223406128,HamzaLegend143,HamzaLegend143,1,1,0,1,2,0,0.010461701
75234492,dueymatt,dueymatt,1,1,0,1,2,0,0.010461701
483065031,hjrhwjhd1,hjrhwjhd1,1,1,0,1,2,0,0.010461701
1926102217,AboMouad87,AboMouad87,1,1,0,1,2,0,0.010461701
2589162710,whbkhorasani,whbkhorasani,1,1,0,1,2,0,0.010461701
104267124,Baahaaji,Baahaaji,1,1,0,1,2,0,0.010461701
969757932,Abusalahudeen1,Abusalahudeen1,1,1,0,1,2,0,0.010461701
2741185090,mansurmustafa21,mansurmustafa21,1,1,0,1,2,0,0.010461701
262667720,buamrah,buamrah,1,1,0,1,2,0,0.010461701
2574941670,TalabAlHaqq,TalabAlHaqq,1,1,0,1,2,0,0.010461701
259915332,n4s33r,n4s33r,1,1,0,1,2,0,0.010461701
1465777748,KhaledMDFJarrar,KhaledMDFJarrar,1,1,0,1,2,0,0.010461701
741572197,ElRevolutionist,ElRevolutionist,1,2,0,2,2,0.5,0.059396452
1115487848,media_indian,media_indian,1,1,0,1,2,0,0.010461701
1533902462,AbuMalik007,AbuMalik007,1,1,0,1,2,0,0.010461701
122191502,thedescrier,thedescrier,1,1,0,1,2,0,0.010461701
521240488,Alwerfally86,Alwerfally86,1,1,0,1,2,0,0.010461701
1590296538,ZarachStar,ZarachStar,1,1,0,1,2,0,0.010461701
2783805453,FaatimaUmmUwais,FaatimaUmmUwais,1,1,0,1,6,0,0.048934752
2782396499,Fisabeelillaah,Fisabeelillaah,1,1,0,1,6,0,0.048934752
2852334266,Uma_Mhd,Uma_Mhd,1,1,0,1,6,0,0.048934752
2655748222,stefmeistern1,stefmeistern1,1,1,0,1,6,0,0.048934752
286818540,wazzaroo08,wazzaroo08,1,1,0,1,6,0,0.048934752
198836488,janeikelboom,janeikelboom,1,0,1,1,6,0,0
2603450643,ErvaEbu,ErvaEbu,1,1,0,1,6,0,0.048934752
42172706,bobkihli,bobkihli,1,1,0,1,6,0,0.048934752
2659222014,abu_ubaida1,abu_ubaida1,1,1,0,1,6,0,0.048934752
309330498,Uncle__Istvan,Uncle__Istvan,1,1,0,1,6,0,0.048934752
371524163,Hodanaayy,Hodanaayy,1,1,0,1,6,0,0.048934752
95027826,serhat61,serhat61,1,1,0,1,6,0,0.048934752
297365700,ABalkhi,ABalkhi,1,0,1,1,6,0,0
1267832257,unsbamir,unsbamir,1,0,1,1,6,0,0
103056019,DesmondKreijne,DesmondKreijne,1,1,0,1,6,0,0.048934752
17629860,FBI,FBI,1,0,1,1,6,0,0
292750011,kashif785,kashif785,1,1,0,1,6,0,0.048934752
151323367,Ahmkha3,Ahmkha3,1,1,0,1,6,0,0.048934752
2544501487,Swalehfazul,Swalehfazul,1,1,0,1,6,0,0.048934752
2769453911,IffatMa,IffatMa,1,1,0,1,6,0,0.048934752
51850045,yushaevans,yushaevans,1,0,2,2,6,0.5,0
2809981761,huya4447198,huya4447198,1,1,0,1,6,0,0.048934752
2486829978,samyleqarovi,samyleqarovi,1,1,0,1,6,0,0.048934752
1944191912,FoyjullahKhan,FoyjullahKhan,1,1,0,1,6,0,0.048934752
253002726,LifeMovingOn,LifeMovingOn,1,1,0,1,6,0,0.048934752
2831352864,MUHAMMADMOJAHID,MUHAMMADMOJAHID,1,1,0,1,6,0,0.048934752
2768372775,AbuAnwarAyman,AbuAnwarAyman,1,1,0,1,6,0,0.048934752
22545453,RANDCorporation,RANDCorporation,1,0,1,1,6,0,0
352552001,MorenazaLyl,MorenazaLyl,1,1,0,1,6,0,0.048934752
2190509127,AbuHindMuhajir,AbuHindMuhajir,1,0,1,1,6,0,0
1976632417,yassertsonga,yassertsonga,1,1,0,1,6,0,0.048934752
2849277115,anakbaba77,anakbaba77,1,2,0,2,6,1,0.082326345
1234633951,abu_salih8,abu_salih8,1,0,1,1,6,0,0
2355594481,UmmSuleym,UmmSuleym,1,1,1,2,6,0,0.048934752
2764408108,UmmMuhammed_,UmmMuhammed_,1,1,0,1,6,0,0.048934752
31452042,GRCOOTE,GRCOOTE,1,1,0,1,6,0,0.048934752
10126672,USMC,USMC,1,0,1,1,6,0,0
2743567727,SARCEMaitre,SARCEMaitre,1,1,0,1,6,0,0.048934752
2759349823,Roman122334,Roman122334,1,1,0,1,6,0,0.048934752
2820441492,islamigiyim,islamigiyim,1,1,0,1,6,0,0.048934752
2561213851,Fatmayussuuf,Fatmayussuuf,1,1,0,1,6,0,0.048934752
189662629,ArtWendeley,ArtWendeley,1,1,0,1,6,0,0.048934752
844301744,SalahAdinn,SalahAdinn,1,1,0,1,6,0,0.048934752
744293815,sabinafairuz,sabinafairuz,1,1,0,1,6,0,0.048934752
1911883202,abu__maryam,abu__maryam,1,1,0,1,6,0,0.048934752
32933328,HATzortzis,HATzortzis,1,0,1,1,6,0,0
2349205004,xcon_cp_dc,xcon_cp_dc,1,1,0,1,6,0,0.048934752
1438058016,Just_ME1900,Just_ME1900,1,1,0,1,6,0,0.048934752
412026404,DrMohamadYousri,DrMohamadYousri,1,0,1,1,6,0,0
2715321933,malikjavaid321,malikjavaid321,1,1,0,1,6,0,0.048934752
2695300686,sanghe65,sanghe65,1,1,0,1,6,0,0.048934752
2820933234,ummultahirah01,ummultahirah01,1,1,0,1,6,0,0.048934752
2827126417,neena19972,neena19972,1,1,0,1,6,0,0.048934752
2536900289,mjhdns,mjhdns,1,1,1,2,6,0,0.048934752
2794522324,5b7298530c254cd,5b7298530c254cd,1,1,0,1,6,0,0.048934752
1709967073,musabu9,musabu9,1,1,0,1,6,0,0.048934752
148903549,HizbutTahrirNL,HizbutTahrirNL,1,0,1,1,6,0,0
2763163473,ali_jihadali368,ali_jihadali368,1,1,0,1,6,0,0.048934752
129861504,pinoroig,pinoroig,1,1,0,1,6,0,0.048934752
2834270101,Rahman8Saif,Rahman8Saif,1,1,0,1,6,0,0.048934752
2646149029,galatolosa582,galatolosa582,1,1,0,1,6,0,0.048934752
2740455405,HusnuHusnayain,HusnuHusnayain,1,1,0,1,6,0,0.048934752
333350896,AlexisHenrio,AlexisHenrio,1,1,0,1,6,0,0.048934752
2701658138,xukur424,xukur424,1,2,0,2,6,1,0.082326345
2485813597,kaleelhaja,kaleelhaja,1,1,0,1,6,0,0.048934752
222953824,gov,gov,1,0,1,1,6,0,0
1050282073,RedRay01,RedRay01,1,1,0,1,6,0,0.048934752
2828470363,Muax001100,Muax001100,1,1,0,1,6,0,0.048934752
2330626182,AceMasterson,AceMasterson,1,1,0,1,6,0,0.048934752
1400146058,shafqatbhat2,shafqatbhat2,1,1,0,1,6,0,0.048934752
2194671755,Joynul_Jaman,Joynul_Jaman,1,0,1,1,6,0,0
253954189,BesikciogluErdl,BesikciogluErdl,1,1,0,1,6,0,0.048934752
2786887922,ivanarmadi2,ivanarmadi2,1,1,1,2,6,0,0.048934752
2387806475,ADjound,ADjound,1,1,0,1,6,0,0.048934752
2541568400,ahmmada721,ahmmada721,1,1,0,1,6,0,0.048934752
2811922789,abu_maryam021,abu_maryam021,1,1,0,1,6,0,0.048934752
2850425191,AbuMusaSomali,AbuMusaSomali,1,1,0,1,6,0,0.048934752
2798061961,SyaifullahX,SyaifullahX,1,1,0,1,6,0,0.048934752
1556580794,globaltawheed,globaltawheed,1,0,1,1,6,0,0
263981499,Quickieleaks,Quickieleaks,1,1,1,2,6,0,0.048934752
2567473620,abuhamza0505046,abuhamza0505046,1,1,0,1,6,0,0.048934752
2831800057,lspacejam,lspacejam,1,1,0,1,6,0,0.048934752
409176583,FreeSyrianArmy,FreeSyrianArmy,1,0,1,1,6,0,0
2767555087,o1980one,o1980one,1,1,0,1,6,0,0.048934752
2613676560,KRAD110,KRAD110,1,1,0,1,6,0,0.048934752
312929369,nabers91,nabers91,1,1,0,1,6,0,0.048934752
1623329354,ExpiredControl,ExpiredControl,1,1,0,1,6,0,0.048934752
2836957844,SFulcrum,SFulcrum,1,1,0,1,6,0,0.048934752
2760411802,NikkahOnline_,NikkahOnline_,1,1,1,2,6,0,0.048934752
2739210959,UmmRumaysae,UmmRumaysae,1,1,0,1,6,0,0.048934752
2315946704,UkhtyGhareebah,UkhtyGhareebah,1,1,0,1,6,0,0.048934752
2427849524,umer_uz,umer_uz,1,1,0,1,6,0,0.048934752
2753497936,UmAliiyah,UmAliiyah,1,1,0,1,6,0,0.048934752
1414302571,Abu_Macintosh,Abu_Macintosh,1,1,1,2,6,0,0.048934752
2178517878,AshleyMalik331,AshleyMalik331,1,1,0,1,6,0,0.048934752
406358930,TashyAbrahams,TashyAbrahams,1,1,0,1,6,0,0.048934752
2593065891,Muslimah3311,Muslimah3311,1,1,0,1,6,0,0.048934752
316279716,abu0nuha,abu0nuha,1,1,0,1,6,0,0.048934752
14912431,theofficial_zee,theofficial_zee,1,1,0,1,6,0,0.048934752
2828627107,abd_muni,abd_muni,1,1,0,1,6,0,0.048934752
2659486730,CestSunnah,CestSunnah,1,1,0,1,6,0,0.048934752
2835123212,KDIPress2,KDIPress2,1,1,0,1,6,0,0.048934752
573869119,amiaumi,amiaumi,1,1,0,1,6,0,0.048934752
2665802180,firufiroz143,firufiroz143,1,1,0,1,6,0,0.048934752
2734918736,Rasheed1265,Rasheed1265,1,1,0,1,6,0,0.048934752
2605354076,TawhidTonoy,TawhidTonoy,1,1,0,1,6,0,0.048934752
2769587300,Hamzamod1,Hamzamod1,1,1,0,1,6,0,0.048934752
2679475308,kunde_al,kunde_al,1,1,0,1,6,0,0.048934752
2613185657,squared9,squared9,1,1,0,1,6,0,0.048934752
2763754628,abed_zain23,abed_zain23,1,1,0,1,6,0,0.048934752
441978000,ihsan_BD,ihsan_BD,1,0,1,1,6,0,0
984517801,AbdAllahGaza,AbdAllahGaza,1,1,0,1,6,0,0.048934752
2778827960,OrientWriter,OrientWriter,1,1,0,1,6,0,0.048934752
544771289,Ablhohuseyn,Ablhohuseyn,1,1,0,1,6,0,0.048934752
40439058,fuckingness,fuckingness,1,1,0,1,6,0,0.048934752
14159148,UN,UN,1,0,1,1,6,0,0
2752351560,IbnMuhammad313,IbnMuhammad313,1,1,0,1,6,0,0.048934752
2701004132,rruci1,rruci1,1,1,0,1,6,0,0.048934752
134811006,BenjaminFCraig,BenjaminFCraig,1,1,0,1,6,0,0.048934752
774212996,Suppiliuliuma,Suppiliuliuma,1,1,0,1,6,0,0.048934752
2631838956,CowboyImran,CowboyImran,1,1,0,1,6,0,0.048934752
1363545486,youssefke16,youssefke16,1,1,0,1,6,0,0.048934752
76221855,QuranWeekly,QuranWeekly,1,0,1,1,6,0,0
2742357420,NewsHound93,NewsHound93,1,1,0,1,6,0,0.048934752
54312197,hombreinvisibel,hombreinvisibel,1,1,0,1,6,0,0.048934752
30313925,WhiteHouse,WhiteHouse,1,0,1,1,6,0,0
2751729113,deepis_CR7,deepis_CR7,1,1,0,1,6,0,0.048934752
2412645854,AbuHafs1435,AbuHafs1435,1,1,0,1,6,0,0.048934752
2604862952,Nazirbhat4,Nazirbhat4,1,1,0,1,6,0,0.048934752
948735565,islamiz_deen,islamiz_deen,1,1,0,1,6,0,0.048934752
2639007335,abdullah9ab2,abdullah9ab2,1,1,0,1,6,0,0.048934752
2342358649,Kozizou01,Kozizou01,1,1,0,1,6,0,0.048934752
2512752272,AbooHurayrahAS,AbooHurayrahAS,1,0,1,1,6,0,0
178622158,GreenBird369,GreenBird369,1,1,0,1,6,0,0.048934752
2610433747,ISFatwa,ISFatwa,1,0,1,1,6,0,0
2651655901,AbuIbrahimIslam,AbuIbrahimIslam,1,1,0,1,6,0,0.048934752
2589429499,AbuSfynAliraqi,AbuSfynAliraqi,1,1,0,1,6,0,0.048934752
2299675268,mesjideaqsa34,mesjideaqsa34,1,1,0,1,6,0,0.048934752
2571800360,Abu_MusaM,Abu_MusaM,1,1,1,2,6,0,0.048934752
2657718062,asimriaz78,asimriaz78,1,1,0,1,6,0,0.048934752
1573162801,ubekirersoz,ubekirersoz,1,1,0,1,6,0,0.048934752
2799636369,AbuSalamah5,AbuSalamah5,1,1,0,1,6,0,0.048934752
2728988577,Salahuddinmusl1,Salahuddinmusl1,1,1,0,1,6,0,0.048934752
2505478059,ramik488,ramik488,1,1,0,1,6,0,0.048934752
2496532422,AbouBakrAlTurki,AbouBakrAlTurki,1,1,1,2,6,0,0.048934752
2846560206,Sanskunya,Sanskunya,1,1,0,1,6,0,0.048934752
142807001,LuqmanSaeed,LuqmanSaeed,1,1,0,1,6,0,0.048934752
2813759451,PACIFISME1,PACIFISME1,1,1,0,1,6,0,0.048934752
2532937718,AbuGhazwa,AbuGhazwa,1,1,1,2,6,0,0.048934752
2431455247,BluessHeriro,BluessHeriro,1,1,0,1,6,0,0.048934752
239865886,tajimustafa,tajimustafa,1,0,1,1,6,0,0
2725580846,alhindi13,alhindi13,1,1,0,1,6,0,0.048934752
19763256,yarabayoumy,yarabayoumy,1,1,0,1,6,0,0.048934752
2796392543,AbuyahyaMagreb,AbuyahyaMagreb,1,0,1,1,6,0,0
2730004604,Abu_suleyman123,Abu_suleyman123,1,1,0,1,6,0,0.048934752
2695237773,Sidsar82,Sidsar82,1,1,0,1,6,0,0.048934752
2723693266,ajalil746,ajalil746,1,1,0,1,6,0,0.048934752
2579978281,1noorul_hasan,1noorul_hasan,1,1,0,1,6,0,0.048934752
562991382,u_abdullahi,u_abdullahi,1,1,0,1,6,0,0.048934752
49622408,ammachoo,ammachoo,1,1,0,1,6,0,0.048934752
2298351959,cameroonny,cameroonny,1,0,1,1,6,0,0
2784694627,redroos9,redroos9,1,1,0,1,6,0,0.048934752
2787447196,AissaGhuraba,AissaGhuraba,1,1,0,1,6,0,0.048934752
2788069814,hasanhasan1616,hasanhasan1616,1,1,0,1,6,0,0.048934752
1582469563,nolongerinuse_9,nolongerinuse_9,1,0,1,1,6,0,0
128750032,radit_dgreatz,radit_dgreatz,1,1,0,1,6,0,0.048934752
2596704750,Yaspr1,Yaspr1,1,1,0,1,6,0,0.048934752
1407324680,assuleym,assuleym,1,1,0,1,6,0,0.048934752
2732364347,abdullkhan76314,abdullkhan76314,1,1,0,1,6,0,0.048934752
1527714396,StartSharia,StartSharia,1,1,0,1,6,0,0.048934752
2793378549,HazmNasr,HazmNasr,1,0,1,1,6,0,0
1627460342,mmmirmmmaa,mmmirmmmaa,1,1,0,1,6,0,0.048934752
16159499,brandi_vineyard,brandi_vineyard,1,1,0,1,6,0,0.048934752
2561708827,man_jimba,man_jimba,1,0,1,1,6,0,0
150717232,gr8virtue,gr8virtue,1,1,0,1,6,0,0.048934752
634721078,jaafarz67,jaafarz67,1,1,0,1,6,0,0.048934752
2473657146,incanewsEnglish,incanewsEnglish,1,1,0,1,6,0,0.048934752
2409403250,Ratamas1985,Ratamas1985,1,1,0,1,6,0,0.048934752
2781254548,Ibrahheemmm,Ibrahheemmm,1,1,0,1,6,0,0.048934752
2754483115,AhmadiAhmadi92,AhmadiAhmadi92,1,1,0,1,6,0,0.048934752
230527949,AnonymousPress,AnonymousPress,1,0,1,1,6,0,0
2251232241,AbuDjango_,AbuDjango_,1,1,0,1,6,0,0.048934752
132322374,noumanbayyinah,noumanbayyinah,1,0,1,1,6,0,0
2820282552,ummalsaif,ummalsaif,1,1,0,1,6,0,0.048934752
2616005744,__UmmIsra,__UmmIsra,1,1,0,1,6,0,0.048934752
1268814968,baniaspresager,baniaspresager,1,1,0,1,6,0,0.048934752
253727901,DawahDaily,DawahDaily,1,0,1,1,6,0,0
49779883,Abuhafs,Abuhafs,1,0,1,1,6,0,0
1082987695,AyyBeeShafi,AyyBeeShafi,1,1,0,1,6,0,0.048934752
2196477150,roybenzema1,roybenzema1,1,1,0,1,6,0,0.048934752
237344036,patrick_sykes,patrick_sykes,1,1,0,1,6,0,0.048934752
17438045,llepape,llepape,1,1,0,1,6,0,0.048934752
102831534,nidnetal,nidnetal,1,1,0,1,6,0,0.048934752
232297912,ChrisHartAuthor,ChrisHartAuthor,1,1,0,1,6,0,0.048934752
2501580240,rebinomer2,rebinomer2,1,1,0,1,6,0,0.048934752
91067861,ixhian,ixhian,1,1,0,1,6,0,0.048934752
2655163864,AbuMusa_1,AbuMusa_1,1,1,0,1,6,0,0.048934752
2783909337,greenbird773,greenbird773,1,1,0,1,6,0,0.048934752
2339378661,game92043,game92043,1,1,0,1,6,0,0.048934752
2789905899,dhahiri1,dhahiri1,1,1,0,1,6,0,0.048934752
2794722882,Wasir_Aadley,Wasir_Aadley,1,1,0,1,6,0,0.048934752
2782434889,17thswordsman,17thswordsman,1,1,0,1,6,0,0.048934752
2548209271,GlifoneaNhiel,GlifoneaNhiel,1,1,0,1,6,0,0.048934752
2263979668,mhdhaf,mhdhaf,1,1,0,1,6,0,0.048934752
175085210,140_Islam,140_Islam,1,0,1,1,6,0,0
2509838030,_Abdul_Wadud_,_Abdul_Wadud_,1,1,0,1,6,0,0.048934752
2771807864,JundAksa,JundAksa,1,1,0,1,6,0,0.048934752
1581553405,AbouMadyaneMM,AbouMadyaneMM,1,1,0,1,6,0,0.048934752
1397659400,Sero_Can91,Sero_Can91,1,1,0,1,6,0,0.048934752
2609780522,AbooJaabiir,AbooJaabiir,1,1,0,1,6,0,0.048934752
2832734169,aliismaiill,aliismaiill,1,1,0,1,6,0,0.048934752
153524203,Elinkwijk9,Elinkwijk9,1,1,0,1,6,0,0.048934752
54138882,Abu_Rumaisa,Abu_Rumaisa,1,2,0,2,6,1,0.082326345
2222233640,KhaledAlWaled18,KhaledAlWaled18,1,1,0,1,6,0,0.048934752
2656049203,IbnUmarmjr,IbnUmarmjr,1,1,0,1,6,0,0.048934752
2321291617,Adhy1949,Adhy1949,1,1,0,1,6,0,0.048934752
2712705101,engr_tasiu,engr_tasiu,1,1,0,1,6,0,0.048934752
2655983712,fergusscotland,fergusscotland,1,1,0,1,6,0,0.048934752
2791206589,salamX2014,salamX2014,1,1,0,1,6,0,0.048934752
2406914220,FreeLancerPerk,FreeLancerPerk,1,1,0,1,6,0,0.048934752
2616891681,jasminelyngby,jasminelyngby,1,1,0,1,6,0,0.048934752
2388121990,mehanavushtrri,mehanavushtrri,1,1,0,1,6,0,0.048934752
2835945825,sabrirami1,sabrirami1,1,1,0,1,6,0,0.048934752
19181906,hannahbayman,hannahbayman,1,1,0,1,6,0,0.048934752
429889914,marocamira,marocamira,1,1,0,1,6,0,0.048934752
2526943611,IslamicTribute,IslamicTribute,1,0,1,1,6,0,0
2752911756,moumougf,moumougf,1,1,0,1,6,0,0.048934752
15702417,brianging,brianging,1,1,0,1,6,0,0.048934752
2493815226,vocagil,vocagil,1,1,0,1,6,0,0.048934752
1659607513,al_berjawi,al_berjawi,1,1,0,1,6,0,0.048934752
205396454,khtb_mhjr,khtb_mhjr,1,1,0,1,6,0,0.048934752
453319164,EJDionne,EJDionne,1,0,1,1,6,0,0
2235439614,Fundamentalistz,Fundamentalistz,1,1,0,1,6,0,0.048934752
151001647,Faysal_FreeGaza,Faysal_FreeGaza,1,0,1,1,6,0,0
2495912551,IslamArmy_turk,IslamArmy_turk,1,0,1,1,6,0,0
2289572490,FursanMedia,FursanMedia,1,1,0,1,6,0,0.048934752
1706760848,abo5afsalzurmat,abo5afsalzurmat,1,1,0,1,6,0,0.048934752
1093638847,Channel7,Channel7,1,0,1,1,6,0,0
2567281370,ibn0mar,ibn0mar,1,1,1,2,6,0,0.048934752
2281085676,aburamadi,aburamadi,1,1,1,2,6,0,0.048934752
2707364592,backbacher,backbacher,1,1,0,1,6,0,0.048934752
2521930490,Saeed18639093,Saeed18639093,1,1,0,1,6,0,0.048934752
2342296328,xaxam46,xaxam46,1,1,0,1,6,0,0.048934752
32348944,GardenofGold,GardenofGold,1,1,0,1,6,0,0.048934752
176462613,Alhamdhulillaah,Alhamdhulillaah,1,0,1,1,6,0,0
926849844,HalalMates,HalalMates,1,0,1,1,6,0,0
2609027899,mhjrh1996,mhjrh1996,1,1,0,1,6,0,0.048934752
2592906065,bilalismiasim,bilalismiasim,1,1,0,1,6,0,0.048934752
2589236096,PeaceIsFrmAllah,PeaceIsFrmAllah,1,1,0,1,6,0,0.048934752
2515934100,bintdad__,bintdad__,1,0,1,1,6,0,0
2226658212,khidong04,khidong04,1,1,0,1,6,0,0.048934752
2371316126,bale_of,bale_of,1,1,0,1,6,0,0.048934752
382573549,almostaphaalee,almostaphaalee,1,1,0,1,6,0,0.048934752
2676366372,jahangir0297,jahangir0297,1,1,0,1,6,0,0.048934752
1972913330,Ebu_Muhammed_,Ebu_Muhammed_,1,1,0,1,6,0,0.048934752
2596609074,sunlyn111213,sunlyn111213,1,1,0,1,6,0,0.048934752
16129106,USMarineCorps,USMarineCorps,1,0,1,1,6,0,0
344365583,wasi_manzoor,wasi_manzoor,1,1,0,1,6,0,0.048934752
2763922530,abumuawiya2,abumuawiya2,1,1,0,1,6,0,0.048934752
2867108976,mustafsmm74,mustafsmm74,1,1,0,1,6,0,0.048934752
2739313782,AMzeraa,AMzeraa,1,1,0,1,6,0,0.048934752
2620169335,jamesgrant2044,jamesgrant2044,1,1,0,1,6,0,0.048934752
325459110,usman2133,usman2133,1,1,1,2,6,0,0.048934752
354294975,BahrainX,BahrainX,1,1,0,1,6,0,0.048934752
2726632664,Assalaffiyu,Assalaffiyu,1,1,0,1,6,0,0.048934752
276634874,ugaasla,ugaasla,1,1,0,1,6,0,0.048934752
2732170500,Deymanalmujahid,Deymanalmujahid,1,1,0,1,6,0,0.048934752
1265239254,zaidahmed5555,zaidahmed5555,1,1,0,1,6,0,0.048934752
2639293318,wzxhwh,wzxhwh,1,1,0,1,6,0,0.048934752
2398487773,shaheed442,shaheed442,1,1,0,1,6,0,0.048934752
2363104589,abumuhsin12345,abumuhsin12345,1,0,1,1,6,0,0
15113565,USCG,USCG,1,0,1,1,6,0,0
2754752407,sohaibsalafi33,sohaibsalafi33,1,1,0,1,6,0,0.048934752
2359926157,CIA,CIA,1,0,1,1,6,0,0
262610325,Salman_Al_Odah,Salman_Al_Odah,1,0,1,1,6,0,0
2527960496,339cdeeb5a69461,339cdeeb5a69461,1,1,0,1,6,0,0.048934752
2498108878,shahd_asgefe,shahd_asgefe,1,1,0,1,6,0,0.048934752
2700451308,Rebel_Talish,Rebel_Talish,1,1,0,1,6,0,0.048934752
225385966,PierreFourchet,PierreFourchet,1,1,0,1,6,0,0.048934752
1040827657,IBNADAMA,IBNADAMA,1,1,0,1,6,0,0.048934752
15277626,zak55555,zak55555,1,1,0,1,6,0,0.048934752
118726286,khalood7,khalood7,1,1,0,1,6,0,0.048934752
2664013469,Hicham_hasdo,Hicham_hasdo,1,1,0,1,6,0,0.048934752
2526125736,hgjjbakr,hgjjbakr,1,1,0,1,6,0,0.048934752
2746326739,AbuuIslam1,AbuuIslam1,1,1,0,1,6,0,0.048934752
2779094775,abousuleyman84,abousuleyman84,1,1,0,1,6,0,0.048934752
2289966880,abulkhayr911,abulkhayr911,1,0,1,1,6,0,0
1403920170,omar092440,omar092440,1,1,0,1,6,0,0.048934752
337059634,ErikaSolomon,ErikaSolomon,1,1,0,1,6,0,0.048934752
948674359,Khalid_Maghrebi,Khalid_Maghrebi,1,3,5,8,6,0.8,0.084107467
244588357,Watcherone,Watcherone,1,0,1,1,6,0,0
2762743644,bint_bassboussa,bint_bassboussa,1,1,0,1,6,0,0.048934752
2820349871,all_earss,all_earss,1,1,0,1,6,0,0.048934752
2645467092,emaratallah,emaratallah,1,1,0,1,6,0,0.048934752
83402747,coco_navis,coco_navis,1,1,0,1,6,0,0.048934752
2561974304,ShiddhoDim,ShiddhoDim,1,1,0,1,6,0,0.048934752
712548410,Shewar_Sherzad,Shewar_Sherzad,1,1,0,1,6,0,0.048934752
431857735,__Ateeq,__Ateeq,1,1,1,2,6,0,0.048934752
2574459001,IraqConflict,IraqConflict,1,1,0,1,6,0,0.048934752
2656641151,Besimalalbani,Besimalalbani,1,1,0,1,6,0,0.048934752
1440424087,ChaseLaurelle,ChaseLaurelle,1,1,0,1,6,0,0.048934752
1275338960,GokhanTunctan,GokhanTunctan,1,1,0,1,6,0,0.048934752
2276073716,MazharMazhari,MazharMazhari,1,1,0,1,6,0,0.048934752
211722490,yukihotanak,yukihotanak,1,1,0,1,6,0,0.048934752
791879972,TheStrangeFella,TheStrangeFella,1,1,0,1,6,0,0.048934752
2650939730,ABU_MUSAB_KRSNI,ABU_MUSAB_KRSNI,1,1,0,1,6,0,0.048934752
2775458165,muslimah_mulan,muslimah_mulan,1,1,0,1,6,0,0.048934752
2789907184,77islamicstate,77islamicstate,1,1,0,1,6,0,0.048934752
2771952046,Abusuleiman_,Abusuleiman_,1,1,1,2,6,0,0.048934752
59679165,BriefNap,BriefNap,1,1,0,1,6,0,0.048934752
2689049037,8d0bc0a49cfc482,8d0bc0a49cfc482,1,1,0,1,6,0,0.048934752
402629083,mimimelo3,mimimelo3,1,1,0,1,6,0,0.048934752
2308284896,Faqiripi,Faqiripi,1,0,1,1,6,0,0
2819531236,RostomTounisi,RostomTounisi,1,1,0,1,6,0,0.048934752
2738365005,AlAfriki,AlAfriki,1,1,0,1,6,0,0.048934752
2788303489,Azizomohamed,Azizomohamed,1,1,0,1,6,0,0.048934752
2801148554,BinKhatt4b,BinKhatt4b,1,1,0,1,6,0,0.048934752
234070725,mkh1384,mkh1384,1,0,1,1,6,0,0
2798789410,KhilafaWitness_,KhilafaWitness_,1,1,0,1,6,0,0.048934752
1680122660,raidyar,raidyar,1,1,0,1,6,0,0.048934752
2761532207,YaAhlulJannah,YaAhlulJannah,1,0,1,1,6,0,0
2781127549,UmmR03,UmmR03,1,1,0,1,6,0,0.048934752
2379424656,beramansur,beramansur,1,1,0,1,6,0,0.048934752
2596980212,JihadShaam,JihadShaam,1,1,0,1,6,0,0.048934752
2586846156,ISILCats,ISILCats,1,1,1,2,6,0,0.048934752
2786075621,abdijuma02,abdijuma02,1,1,0,1,6,0,0.048934752
76424171,sakinmazz,sakinmazz,1,1,0,1,6,0,0.048934752
328475636,rytcharg,rytcharg,1,1,0,1,6,0,0.048934752
2765136886,zen_aleks,zen_aleks,1,1,0,1,6,0,0.048934752
2799805434,twayruljannah,twayruljannah,1,1,0,1,6,0,0.048934752
2233017462,Shaheeda_4ever,Shaheeda_4ever,1,1,0,1,6,0,0.048934752
2769691819,GulnwazkhanKhan,GulnwazkhanKhan,1,1,0,1,6,0,0.048934752
2783945944,18415dc9f5f745c,18415dc9f5f745c,1,1,0,1,6,0,0.048934752
2793940198,achek_al_jinane,achek_al_jinane,1,1,0,1,6,0,0.048934752
2796332370,03044764971msn,03044764971msn,1,1,0,1,6,0,0.048934752
1261118804,rajab5757,rajab5757,1,1,0,1,6,0,0.048934752
446801247,dfaizanrasool,dfaizanrasool,1,1,0,1,6,0,0.048934752
2667193724,min2crystal1,min2crystal1,1,1,0,1,6,0,0.048934752
2479859070,Shafeeqputhalan,Shafeeqputhalan,1,1,0,1,6,0,0.048934752
2410096039,ISIS_009,ISIS_009,1,0,1,1,6,0,0
2722473397,AYMENKAABI7,AYMENKAABI7,1,1,0,1,6,0,0.048934752
2615244885,AbuNour35,AbuNour35,1,1,0,1,6,0,0.048934752
2792957376,CNiqab,CNiqab,1,1,0,1,6,0,0.048934752
1496327640,BEKTAENDER,BEKTAENDER,1,1,0,1,6,0,0.048934752
2772346337,Abu_Adnaa,Abu_Adnaa,1,1,0,1,6,0,0.048934752
2788632080,abumujahidsom,abumujahidsom,1,1,0,1,6,0,0.048934752
2780636699,abumuntazir14,abumuntazir14,1,1,0,1,6,0,0.048934752
208447030,CassVinograd,CassVinograd,1,1,0,1,6,0,0.048934752
393528929,tafsir5,tafsir5,1,1,0,1,6,0,0.048934752
2298783336,BadriLashkar,BadriLashkar,1,1,0,1,6,0,0.048934752
570009221,MuhibMujahideen,MuhibMujahideen,1,1,0,1,6,0,0.048934752
2751538880,muhammad1187,muhammad1187,1,1,0,1,6,0,0.048934752
985376478,djeko99,djeko99,1,1,0,1,6,0,0.048934752
271883222,alfermanawi,alfermanawi,1,1,0,1,6,0,0.048934752
1612752672,MursalAyub,MursalAyub,1,1,0,1,6,0,0.048934752
2667660937,NamiqUltra,NamiqUltra,1,1,0,1,6,0,0.048934752
1106454338,MazharSharif2,MazharSharif2,1,1,0,1,6,0,0.048934752
279390084,YourAnonNews,YourAnonNews,1,0,1,1,6,0,0
2567251980,rayyanfarizqi,rayyanfarizqi,1,1,0,1,6,0,0.048934752
2793238883,martiniki68,martiniki68,1,1,0,1,6,0,0.048934752
312289380,Bluemanowns,Bluemanowns,1,1,0,1,6,0,0.048934752
2758322340,HebaDelacres,HebaDelacres,1,0,1,1,6,0,0
2603165922,amin110230,amin110230,1,1,0,1,6,0,0.048934752
129018139,UthmanB,UthmanB,1,0,1,1,6,0,0
621717812,AbuSuleimanII,AbuSuleimanII,1,0,1,1,6,0,0
2282268988,dawlah_transltr,dawlah_transltr,1,0,1,1,6,0,0
241403621,abu_hisyam,abu_hisyam,1,1,0,1,6,0,0.048934752
2847779168,NazmieShamsul,NazmieShamsul,1,1,0,1,6,0,0.048934752
169716066,Ramiroo19,Ramiroo19,1,0,1,1,6,0,0
2631608710,monz_moderate,monz_moderate,1,2,0,2,6,0.5,0.059396452
198158811,RajaMike,RajaMike,1,1,0,1,6,0,0.048934752
2828642821,jondaqsa1,jondaqsa1,1,0,1,1,6,0,0
2426841668,Tibyan_media,Tibyan_media,1,0,1,1,6,0,0
2438605387,mikolajkapala,mikolajkapala,1,1,0,1,6,0,0.048934752
2799741528,UmmuJandal,UmmuJandal,1,1,0,1,6,0,0.048934752
601631372,AliShadi3,AliShadi3,1,1,0,1,6,0,0.048934752
102532891,BandaKaba,BandaKaba,1,1,0,1,6,0,0.048934752
2805508794,ares_izrael,ares_izrael,1,1,1,2,6,0,0.048934752
2468915946,SalimOmar99,SalimOmar99,1,1,0,1,6,0,0.048934752
98020078,MoutasimAsim,MoutasimAsim,1,1,0,1,6,0,0.048934752
1585982197,hanifumar14,hanifumar14,1,1,0,1,6,0,0.048934752
2594908930,Mkhan9001Khan,Mkhan9001Khan,1,1,0,1,6,0,0.048934752
2347019023,brunotaveira4,brunotaveira4,1,1,0,1,6,0,0.048934752
951371569,Bang1Mash,Bang1Mash,1,1,0,1,6,0,0.048934752
1708206890,nlowhim,nlowhim,1,1,0,1,6,0,0.048934752
104672085,Palestine531,Palestine531,1,1,0,1,6,0,0.048934752
1478830952,AsmanEnoch,AsmanEnoch,1,1,0,1,6,0,0.048934752
959261562,ManWithBeard_,ManWithBeard_,1,1,1,2,6,0,0.048934752
448048000,l_STRANGER_l,l_STRANGER_l,1,1,0,1,6,0,0.048934752
2766089090,Abu_Dahdah1,Abu_Dahdah1,1,1,0,1,6,0,0.048934752
582396858,saidkhadar,saidkhadar,1,1,1,2,6,0,0.048934752
471542727,bariskekilli1,bariskekilli1,1,1,0,1,6,0,0.048934752
2721393624,MehdiArmy1,MehdiArmy1,1,1,0,1,6,0,0.048934752
395226078,Somalisuperman,Somalisuperman,1,1,0,1,6,0,0.048934752
2645591893,Umm_Umar_,Umm_Umar_,1,1,0,1,6,0,0.048934752
2830085132,MohammadTurki7,MohammadTurki7,1,1,0,1,6,0,0.048934752
2751638604,GhurabaMediaNL,GhurabaMediaNL,1,1,0,1,6,0,0.048934752
2540204569,Islamic_Version,Islamic_Version,1,0,1,1,6,0,0
155888822,Sawban91,Sawban91,1,2,0,2,6,0.5,0.059396452
2586062030,SaAlasyie,SaAlasyie,1,1,0,1,6,0,0.048934752
2763664605,halidsabiha,halidsabiha,1,2,0,2,6,1,0.082326345
314420446,wafasoufan,wafasoufan,1,1,0,1,6,0,0.048934752
2172333369,abdulgafur1413,abdulgafur1413,1,1,0,1,6,0,0.048934752
2460364111,Abuhussaam21,Abuhussaam21,1,1,1,2,6,1,0.033391593
2762859574,IKurdyyah,IKurdyyah,1,1,0,1,6,0,0.048934752
2788961718,abu_nizham82,abu_nizham82,1,1,0,1,6,0,0.048934752
2763369911,taqtaq14,taqtaq14,1,1,0,1,6,0,0.048934752
1968811454,AabuoabAbuouab,AabuoabAbuouab,1,1,0,1,6,0,0.048934752
2626039304,StrongerSmith,StrongerSmith,1,2,0,2,6,1,0.082326345
2640260620,sd1001009095474,sd1001009095474,1,1,0,1,6,0,0.048934752
2429759004,defgrippin,defgrippin,1,2,0,2,6,0.5,0.059396452
2694950442,muahedh05,muahedh05,1,1,0,1,6,0,0.048934752
2700029488,qusayasghar1,qusayasghar1,1,1,0,1,6,0,0.048934752
276672092,fcarrionmolina,fcarrionmolina,1,1,0,1,6,0,0.048934752
2836311691,kambsalfilibini,kambsalfilibini,1,1,0,1,6,0,0.048934752
2456956612,MuslumMaghribi,MuslumMaghribi,1,1,0,1,6,0,0.048934752
224833226,AlessandriaMasi,AlessandriaMasi,1,1,0,1,6,0,0.048934752
2234756845,abdallah_ziwani,abdallah_ziwani,1,1,0,1,6,0,0.048934752
2718248709,AbrahamsZayne,AbrahamsZayne,1,1,0,1,6,0,0.048934752
272543571,RichBoddenberg,RichBoddenberg,1,1,0,1,6,0,0.048934752
2642751351,abulbaraa114,abulbaraa114,1,1,1,2,6,0,0.048934752
2621452186,um_narjis21,um_narjis21,1,1,0,1,6,0,0.048934752
245444603,thepond99,thepond99,1,1,1,2,6,0,0.048934752
2571579397,Jihadenough1,Jihadenough1,1,3,0,3,6,0.8333333,0.092788046
249180181,smekhennet,smekhennet,1,1,0,1,6,0,0.048934752
49918015,G586,G586,1,1,0,1,6,0,0.048934752
2600677487,Josefmwangib,Josefmwangib,1,2,0,2,6,0.5,0.059396452
1316696232,byram70,byram70,1,1,0,1,6,0,0.048934752
2476650714,doenfahri,doenfahri,1,1,0,1,6,0,0.048934752
161657051,David_Churchill,David_Churchill,1,1,0,1,6,0,0.048934752
833302748,FaFahadmyway,FaFahadmyway,1,1,0,1,6,0,0.048934752
961333285,IbraIsmail71,IbraIsmail71,1,1,0,1,6,0,0.048934752
2837098791,houssem712,houssem712,1,1,0,1,6,0,0.048934752
376156461,Sal_kassem,Sal_kassem,1,1,0,1,6,0,0.048934752
2597761394,aallkgdtr2957,aallkgdtr2957,1,1,0,1,6,0,0.048934752
2586358178,malikjbarat,malikjbarat,1,1,0,1,6,0,0.048934752
478556632,ISOI30,ISOI30,1,1,0,1,6,0,0.048934752
819835382,weligama_alert,weligama_alert,1,1,0,1,6,0,0.048934752
15446531,mattyglesias,mattyglesias,1,0,1,1,6,0,0
2690036228,bdr_alsham,bdr_alsham,1,0,1,1,6,0,0
1510022576,Fursan_Malhama,Fursan_Malhama,1,0,1,1,6,0,0
157397542,najitype,najitype,1,1,0,1,6,0,0.048934752
2767008299,Vatos4life,Vatos4life,1,1,0,1,6,0,0.048934752
2401940018,Farhan_Bangalee,Farhan_Bangalee,1,1,0,1,6,0,0.048934752
2394763835,dfa7aeb4030e4f6,dfa7aeb4030e4f6,1,1,0,1,6,0,0.048934752
1713189438,yasser35351,yasser35351,1,1,0,1,6,0,0.048934752
2586325586,yusufandalusi,yusufandalusi,1,1,0,1,6,0,0.048934752
110408311,anjojak,anjojak,1,1,0,1,6,0,0.048934752
438973056,0oOMARo0,0oOMARo0,1,1,0,1,6,0,0.048934752
5943942,SoundCloud,SoundCloud,1,0,1,1,6,0,0
2768548491,charlieroadhate,charlieroadhate,1,1,0,1,6,0,0.048934752
267334287,onreknci,onreknci,1,1,0,1,6,0,0.048934752
2718020252,Lolzens,Lolzens,1,1,0,1,6,0,0.048934752
1554363067,nikhaniks,nikhaniks,1,1,0,1,6,0,0.048934752
2348921533,atiourislam,atiourislam,1,1,0,1,6,0,0.048934752
2754687680,DevleIrakSam,DevleIrakSam,1,1,0,1,6,0,0.048934752
130134724,darshnasoni,darshnasoni,1,1,0,1,6,0,0.048934752
2259989233,Nikah_matching,Nikah_matching,1,1,1,2,6,0,0.048934752
2514662130,ALI72TAHIR,ALI72TAHIR,1,1,0,1,6,0,0.048934752
35697411,thakier,thakier,1,1,0,1,6,0,0.048934752
413577988,geogeorge_10,geogeorge_10,1,1,0,1,6,0,0.048934752
2466984712,fonemisis,fonemisis,1,1,0,1,6,0,0.048934752
2632004429,AbdullahJunior9,AbdullahJunior9,1,1,0,1,6,0,0.048934752
1517532002,Ajan072,Ajan072,1,1,0,1,6,0,0.048934752
2739772905,Musaibr62096517,Musaibr62096517,1,1,0,1,6,0,0.048934752
2798531495,waqti7863,waqti7863,1,1,0,1,6,0,0.048934752
14431145,dayat,dayat,1,1,0,1,6,0,0.048934752
2791912407,VaratchiaN,VaratchiaN,1,1,0,1,6,0,0.048934752
606974962,adnan_sz,adnan_sz,1,1,1,2,6,0,0.048934752
1117434900,KSSHAHUL,KSSHAHUL,1,1,0,1,6,0,0.048934752
2560570419,Yusufsuleiman65,Yusufsuleiman65,1,1,0,1,6,0,0.048934752
1444721737,BasicKn0wledge,BasicKn0wledge,1,0,1,1,6,0,0
320975956,miran_burhan,miran_burhan,1,1,0,1,6,0,0.048934752
2229646433,alikhashogy,alikhashogy,1,1,0,1,6,0,0.048934752
1029420163,ringi69,ringi69,1,1,0,1,6,0,0.048934752
2583427658,Rizmujahid,Rizmujahid,1,1,0,1,6,0,0.048934752
2439427233,Rogubz1,Rogubz1,1,1,0,1,6,0,0.048934752
2559489207,oakbowman,oakbowman,1,1,0,1,6,0,0.048934752
2743547157,jabirissa,jabirissa,1,1,0,1,6,0,0.048934752
198423847,ahmedturnkey,ahmedturnkey,1,0,1,1,6,0,0
2250585391,MuslimDAwarenes,MuslimDAwarenes,1,0,1,1,6,0,0
2763765045,AbdullahYah,AbdullahYah,1,1,0,1,6,0,0.048934752
2836477256,salad5577,salad5577,1,1,0,1,6,0,0.048934752
279688526,AbdulWahidHT,AbdulWahidHT,1,0,1,1,6,0,0
2829825379,Nakbavirtuelle,Nakbavirtuelle,1,1,0,1,6,0,0.048934752
2749019500,abshir_hussein,abshir_hussein,1,1,0,1,6,0,0.048934752
319534525,mohamadalsaidi1,mohamadalsaidi1,1,0,1,1,6,0,0
1286682080,horace_bouillon,horace_bouillon,1,1,0,1,6,0,0.048934752
714618342,Mohamed7902093,Mohamed7902093,1,1,0,1,6,0,0.048934752
2827138541,MouniaMkh,MouniaMkh,1,1,0,1,6,0,0.048934752
2673161710,AminahUmm,AminahUmm,1,1,0,1,6,0,0.048934752
2596451838,tcrag5,tcrag5,1,1,0,1,6,0,0.048934752
428783163,karul_xeran,karul_xeran,1,1,0,1,6,0,0.048934752
1358280270,k4pakistan,k4pakistan,1,0,1,1,6,0,0
2614900308,conquestRome,conquestRome,1,1,0,1,6,0,0.048934752
611797263,ArmstrongFactor,ArmstrongFactor,1,1,0,1,6,0,0.048934752
66369181,DeptofDefense,DeptofDefense,1,0,1,1,6,0,0
2743318248,Tetouani25,Tetouani25,1,1,0,1,6,0,0.048934752
2718119670,ZoobiKhattak,ZoobiKhattak,1,1,0,1,6,0,0.048934752
703379247,EldesEmire,EldesEmire,1,1,0,1,6,0,0.048934752
2235200480,elyasbinyahya,elyasbinyahya,1,1,1,2,6,0,0.048934752
2806986581,Yahya00Badi,Yahya00Badi,1,1,0,1,6,0,0.048934752
2501326685,IIbnAbdAllah,IIbnAbdAllah,1,1,0,1,6,0,0.048934752
2222405482,AbuosamahHijra,AbuosamahHijra,1,0,1,1,6,0,0
1362016135,ffregister,ffregister,1,0,1,1,6,0,0
2252207084,truthseeker1684,truthseeker1684,1,1,0,1,6,0,0.048934752
2611230603,muhammadriyaaz,muhammadriyaaz,1,1,0,1,6,0,0.048934752
2366650304,AandWww,AandWww,1,1,0,1,6,0,0.048934752
2821568473,usamamahmood35,usamamahmood35,1,0,1,1,6,0,0
401618937,farooqabdulaziz,farooqabdulaziz,1,1,0,1,6,0,0.048934752
114341891,TevSmith1,TevSmith1,1,1,0,1,6,0,0.048934752
2641672295,abu_mujahid_sun,abu_mujahid_sun,1,1,0,1,6,0,0.048934752
42027367,asletoje,asletoje,1,1,0,1,6,0,0.048934752
1900689524,jihaad_princess,jihaad_princess,1,1,0,1,6,0,0.048934752
1977858181,matt_nagi,matt_nagi,1,1,0,1,6,0,0.048934752
2147924132,TruthReminders,TruthReminders,1,0,1,1,6,0,0
192133286,fuzail55,fuzail55,1,1,0,1,6,0,0.048934752
1728264402,tazzakir,tazzakir,1,1,0,1,6,0,0.048934752
78592216,TheShifan,TheShifan,1,1,0,1,6,0,0.048934752
2635380962,Munyerring,Munyerring,1,1,0,1,6,0,0.048934752
365181213,axeeniho,axeeniho,1,1,0,1,6,0,0.048934752
2792442245,s_tauhid_rush,s_tauhid_rush,1,1,0,1,6,0,0.048934752
2742042003,TawhidFlag,TawhidFlag,1,1,0,1,6,0,0.048934752
2743318841,AbouYassine92,AbouYassine92,1,1,0,1,6,0,0.048934752
2805905799,SomaliAbu,SomaliAbu,1,1,0,1,6,0,0.048934752
2746530186,PetgovPett,PetgovPett,1,1,0,1,6,0,0.048934752
2805905900,Aboe_Roewaahah,Aboe_Roewaahah,1,1,0,1,6,0,0.048934752
2443065916,Sons_of_khilafa,Sons_of_khilafa,1,1,0,1,6,0,0.048934752
2316612704,KhalidUlRehman,KhalidUlRehman,1,1,0,1,6,0,0.048934752
18528834,US_Air_Force,US_Air_Force,1,0,1,1,6,0,0
2298821193,mike_nicehiller,mike_nicehiller,1,1,0,1,6,0,0.048934752
277166741,ajayalghaani,ajayalghaani,1,1,0,1,6,0,0.048934752
1414478486,PMSPMS,PMSPMS,1,1,0,1,6,0,0.048934752
2725296834,Phenixt369,Phenixt369,1,1,0,1,6,0,0.048934752
2614672093,ClevelandKid21,ClevelandKid21,1,1,0,1,6,0,0.048934752
2758523627,tabu_sanders,tabu_sanders,1,1,0,1,6,0,0.048934752
252998786,Assimalhakeem,Assimalhakeem,1,0,1,1,6,0,0
19086179,BabakDehghan,BabakDehghan,1,1,0,1,6,0,0.048934752
2648193896,SweDeen2,SweDeen2,1,1,0,1,6,0,0.048934752
2603268986,paraphenomene,paraphenomene,1,1,0,1,6,0,0.048934752
18430860,littlerosy15,littlerosy15,1,1,0,1,6,0,0.048934752
2785557389,AyubiSalahaddin,AyubiSalahaddin,1,1,0,1,6,0,0.048934752
2711239570,b_muwahid,b_muwahid,1,1,0,1,6,0,0.048934752
2762029976,abu_mujahiden,abu_mujahiden,1,1,0,1,6,0,0.048934752
628145073,nizamanisahib,nizamanisahib,1,1,0,1,6,0,0.048934752
797391816,onais007,onais007,1,1,0,1,6,0,0.048934752
2799320036,moemoeyat,moemoeyat,1,1,0,1,6,0,0.048934752
774126613,HaciSakirt,HaciSakirt,1,1,0,1,6,0,0.048934752
243711009,NabilAlawadhy,NabilAlawadhy,1,0,1,1,6,0,0
1900624932,sidutbell,sidutbell,1,1,0,1,6,0,0.048934752
2556312626,santosoAlWardah,santosoAlWardah,1,1,0,1,6,0,0.048934752
331168924,Khilafahcom,Khilafahcom,1,0,1,1,6,0,0
229588131,Ridwaan_Amra,Ridwaan_Amra,1,1,0,1,6,0,0.048934752
2552708282,Asadullah1967,Asadullah1967,1,1,0,1,6,0,0.048934752
2777889999,AbuKanadi,AbuKanadi,1,1,0,1,6,0,0.048934752
409025752,15arif1992,15arif1992,1,1,0,1,6,0,0.048934752
314719526,safiyaa7,safiyaa7,1,1,0,1,6,0,0.048934752
1341996349,SCM_Syria,SCM_Syria,1,0,1,1,6,0,0
2319105355,OumElFarouk,OumElFarouk,1,1,0,1,6,0,0.048934752
110181764,POLLOSGLOCK,POLLOSGLOCK,1,1,0,1,6,0,0.048934752
2690989449,IsmailMijai,IsmailMijai,1,1,0,1,6,0,0.048934752
334514762,keylala88,keylala88,1,1,0,1,6,0,0.048934752
232472025,aarmiska,aarmiska,1,1,0,1,6,0,0.048934752
2752727633,izberovic5,izberovic5,1,1,0,1,6,0,0.048934752
2696756720,moizuddin6464,moizuddin6464,1,1,0,1,6,0,0.048934752
2312715823,AlFurqanArabic,AlFurqanArabic,1,0,1,1,6,0,0
2808135222,0lastsforever,0lastsforever,1,1,0,1,6,0,0.048934752
1140113018,W7damnalbashar,W7damnalbashar,1,1,0,1,6,0,0.048934752
392281756,MattThompson777,MattThompson777,1,1,0,1,6,0,0.048934752
2741911197,ALmohejir,ALmohejir,1,1,0,1,6,0,0.048934752
231653036,JSchanzer,JSchanzer,1,0,1,1,6,0,0
164380335,saad_kopite_07,saad_kopite_07,1,1,0,1,6,0,0.048934752
2555035320,AbuAdam0071,AbuAdam0071,1,1,0,1,6,0,0.048934752
2767240903,yassinwerghi,yassinwerghi,1,1,0,1,6,0,0.048934752
708034261,mehmoodafridi8,mehmoodafridi8,1,1,0,1,6,0,0.048934752
2731196145,Dawdamuhamed,Dawdamuhamed,1,1,0,1,6,0,0.048934752
2757312260,Amjadul87053469,Amjadul87053469,1,1,0,1,6,0,0.048934752
294073651,hedeftevhid,hedeftevhid,1,1,0,1,6,0,0.048934752
2234957620,RosnoTarkan,RosnoTarkan,1,1,0,1,6,0,0.048934752
405323600,zacxpoltex,zacxpoltex,1,1,0,1,6,0,0.048934752
19611483,usairforce,usairforce,1,0,1,1,6,0,0
2827435933,umm_fuqara,umm_fuqara,1,1,0,1,6,0,0.048934752
1020739602,MakuyaJr1,MakuyaJr1,1,1,0,1,6,0,0.048934752
346931288,Jewish_Lobby,Jewish_Lobby,1,1,0,1,6,0,0.048934752
2328379482,iamparawaseem,iamparawaseem,1,1,0,1,6,0,0.048934752
1862779004,GASMalaysia,GASMalaysia,1,1,0,1,6,0,0.048934752
330678412,HussainKamani,HussainKamani,1,0,1,1,6,0,0
2184954030,phoover92,phoover92,1,1,0,1,6,0,0.048934752
2779005103,amarkin1506,amarkin1506,1,1,0,1,6,0,0.048934752
2588852407,al_matyr,al_matyr,1,1,0,1,6,0,0.048934752
2688434367,AbuHadjer,AbuHadjer,1,1,0,1,6,0,0.048934752
2733424850,abu_khalid632,abu_khalid632,1,1,0,1,6,0,0.048934752
2679882088,RKuntaev,RKuntaev,1,1,0,1,6,0,0.048934752
969654674,zarrar181,zarrar181,1,1,0,1,6,0,0.048934752
6406572,sarottimohr,sarottimohr,1,1,0,1,6,0,0.048934752
2468397496,estadoislamico,estadoislamico,1,1,1,2,6,0,0.048934752
2818327134,AbbyR0DD,AbbyR0DD,1,1,0,1,6,0,0.048934752
2794013295,KhorasanSwords,KhorasanSwords,1,1,0,1,6,0,0.048934752
2595414120,AbuAbd25,AbuAbd25,1,1,0,1,6,0,0.048934752
2798895744,Nanggroe1,Nanggroe1,1,1,0,1,6,0,0.048934752
16859797,muslimvoices,muslimvoices,1,0,1,1,6,0,0
326255267,BuzzFeedAndrew,BuzzFeedAndrew,1,0,1,1,6,0,0
2607563461,mehranmemon121,mehranmemon121,1,1,0,1,6,0,0.048934752
365150918,jayj0001,jayj0001,1,1,0,1,6,0,0.048934752
22332114,MuslimMatters,MuslimMatters,1,0,1,1,6,0,0
2217276878,AbuHanifah02,AbuHanifah02,1,1,0,1,6,0,0.048934752
2253341443,Abdullah123456D,Abdullah123456D,1,1,0,1,6,0,0.048934752
2336178962,Gemayu45,Gemayu45,1,1,0,1,6,0,0.048934752
2736997144,wursz,wursz,1,1,0,1,6,0,0.048934752
863499750,DONREHAN7007,DONREHAN7007,1,1,0,1,6,0,0.048934752
127484791,meryem114,meryem114,1,1,0,1,6,0,0.048934752
101827448,alhonini,alhonini,1,0,1,1,6,0,0
2703737758,abumoosa9892,abumoosa9892,1,1,0,1,6,0,0.048934752
955106263,SSliped7,SSliped7,1,1,0,1,6,0,0.048934752
2603631577,klkakaja81,klkakaja81,1,1,0,1,6,0,0.048934752
2602091552,Wahidisis1,Wahidisis1,1,1,0,1,6,0,0.048934752
2817082448,aaabuibrahim,aaabuibrahim,1,1,0,1,6,0,0.048934752
2486846566,aboenassim,aboenassim,1,1,0,1,6,0,0.048934752
2849784938,RostomAbu,RostomAbu,1,1,0,1,6,0,0.048934752
2849169601,utusanwahyu,utusanwahyu,1,1,0,1,6,0,0.048934752
21251225,AbdulNasirJ,AbdulNasirJ,1,0,1,1,6,0,0
88409229,AbuuSuhaylah,AbuuSuhaylah,1,1,0,1,6,0,0.048934752
2730837232,Twit_AbuNoor,Twit_AbuNoor,1,1,0,1,6,0,0.048934752
2841097772,abuhamza2365,abuhamza2365,1,1,0,1,6,0,0.048934752
1643824446,Highskyq8,Highskyq8,1,1,0,1,6,0,0.048934752
2190755166,imam_quthub,imam_quthub,1,1,0,1,6,0,0.048934752
2451719528,QaqaTamimi,QaqaTamimi,1,1,0,1,6,0,0.048934752
355169856,saad_alkhathlan,saad_alkhathlan,1,0,1,1,6,0,0
2723530165,akbd1983,akbd1983,1,1,0,1,6,0,0.048934752
2308621789,SahabaQuotes,SahabaQuotes,1,1,1,2,6,0,0.048934752
1339835893,HillaryClinton,HillaryClinton,1,0,1,1,6,0,0
2784183844,mediaLIESalways,mediaLIESalways,1,1,0,1,6,0,0.048934752
37013113,halona,halona,1,1,0,1,6,0,0.048934752
319735431,ShkhAbdulRaheem,ShkhAbdulRaheem,1,0,1,1,6,0,0
2616542880,Marwan_Hadid1,Marwan_Hadid1,1,1,0,1,6,0,0.048934752
205375151,Thevik007,Thevik007,1,1,0,1,6,0,0.048934752
111691454,jonleeanderson,jonleeanderson,1,0,1,1,6,0,0
137479884,SR093,SR093,1,1,1,2,6,0,0.048934752
2391292902,nasir_alsharia1,nasir_alsharia1,1,1,0,1,6,0,0.048934752
49432303,YasirQadhi,YasirQadhi,1,0,1,1,6,0,0
996624120,wafiy05,wafiy05,1,1,0,1,6,0,0.048934752
463324939,thechonman,thechonman,1,1,0,1,6,0,0.048934752
2494580526,AbdulhakimHass5,AbdulhakimHass5,1,1,0,1,6,0,0.048934752
2360821556,Abu112Mohamed,Abu112Mohamed,1,1,0,1,6,0,0.048934752
2568406915,IslamAllousheng,IslamAllousheng,1,0,1,1,6,0,0
228411292,Maximus_young,Maximus_young,1,1,0,1,6,0,0.048934752
544360427,Jamiesha_Maj,Jamiesha_Maj,1,1,0,1,6,0,0.048934752
2772027380,UMMAHUNITED1,UMMAHUNITED1,1,1,0,1,6,0,0.048934752
21383161,beirutreporter,beirutreporter,1,0,1,1,6,0,0
1712048132,AbouAndalouss,AbouAndalouss,1,1,0,1,6,0,0.048934752
1855509859,idaretwahoch,idaretwahoch,1,1,0,1,6,0,0.048934752
2167654550,FaresAdile,FaresAdile,1,1,0,1,6,0,0.048934752
1532840131,iamabdullaahsan,iamabdullaahsan,1,1,1,2,6,0,0.048934752
237619417,amshehri,amshehri,1,0,1,1,6,0,0
2865809646,gussbarell1,gussbarell1,1,1,0,1,6,0,0.048934752
2663566379,al_kazahi,al_kazahi,1,1,0,1,6,0,0.048934752
797526276,a_assera,a_assera,1,0,1,1,6,0,0
1642154322,AdnanLovesAllah,AdnanLovesAllah,1,0,1,1,6,0,0
487573872,Muhibbu_Dawlah,Muhibbu_Dawlah,1,1,0,1,6,0,0.048934752
2631551349,muslimcrescent1,muslimcrescent1,1,1,0,1,6,0,0.048934752
2739882361,Ay_File,Ay_File,1,1,0,1,6,0,0.048934752
2336475522,Loyal_To_IS,Loyal_To_IS,1,1,0,1,6,0,0.048934752
2648918405,leynnadia,leynnadia,1,1,0,1,6,0,0.048934752
353941229,Big_Imy,Big_Imy,1,1,0,1,6,0,0.048934752
2727143946,abuimran6024,abuimran6024,1,1,0,1,6,0,0.048934752
2767374827,Faruq_Al_Almani,Faruq_Al_Almani,1,0,1,1,6,0,0
523258375,faraji_mrisho,faraji_mrisho,1,1,0,1,6,0,0.048934752
783436315,mohammadfaizren,mohammadfaizren,1,1,0,1,6,0,0.048934752
2715306531,Drsajaddar,Drsajaddar,1,1,0,1,6,0,0.048934752
2755152450,AbuHafsAussie,AbuHafsAussie,1,1,0,1,6,0,0.048934752
1897024118,Janne_Fylking,Janne_Fylking,1,1,0,1,6,0,0.048934752
552553166,sanzelma,sanzelma,1,1,0,1,6,0,0.048934752
1128942319,AliHusseinChoub,AliHusseinChoub,1,1,0,1,6,0,0.048934752
2762394380,KhilafatRevival,KhilafatRevival,1,1,0,1,6,0,0.048934752
1001147186,HassanCgAshfaq,HassanCgAshfaq,1,1,1,2,6,0,0.048934752
2604976982,samifrmgkp,samifrmgkp,1,1,0,1,6,0,0.048934752
1230392156,faida_kabaju,faida_kabaju,1,2,0,2,6,1,0.082326345
2586200966,abdulla7Samawie,abdulla7Samawie,1,1,0,1,6,0,0.048934752
2737752974,moabibkhab,moabibkhab,1,1,0,1,6,0,0.048934752
911068057,Al_Muhajiroun,Al_Muhajiroun,1,0,1,1,6,0,0
1332562844,silent_hero153,silent_hero153,1,1,0,1,6,0,0.048934752
2789591977,khanjani068,khanjani068,1,1,0,1,6,0,0.048934752
390089644,AlJazeeraPR,AlJazeeraPR,1,0,1,1,6,0,0
2727436788,JsmithJsmith101,JsmithJsmith101,1,1,0,1,6,0,0.048934752
122276838,ibn_mohammadh,ibn_mohammadh,1,1,0,1,6,0,0.048934752
1045908500,MuftiARM,MuftiARM,1,0,1,1,6,0,0
2802207775,WiraHijran,WiraHijran,1,1,0,1,6,0,0.048934752
1289440322,Medias24,Medias24,1,1,0,1,6,0,0.048934752
2394672200,moenandars,moenandars,1,1,0,1,6,0,0.048934752
2834943068,ninja13records,ninja13records,1,1,0,1,6,0,0.048934752
2540194970,Khairaummah_org,Khairaummah_org,1,1,0,1,6,0,0.048934752
329698530,ibn_hamza,ibn_hamza,1,1,1,2,6,0,0.048934752
157535479,sabbeerahmaad,sabbeerahmaad,1,2,0,2,6,1,0.082326345
515525892,yamin_wani,yamin_wani,1,1,0,1,6,0,0.048934752
2745847047,almuyahid02,almuyahid02,1,1,0,1,6,0,0.048934752
2619886870,bshar2014sh1,bshar2014sh1,1,1,0,1,6,0,0.048934752
2538360098,AbidAh1578,AbidAh1578,1,1,0,1,6,0,0.048934752
2632431501,Abusaad_muhajir,Abusaad_muhajir,1,1,0,1,6,0,0.048934752
1467698594,NoraIlli,NoraIlli,1,1,0,1,6,0,0.048934752
2566868395,Abu_Sufyaan_,Abu_Sufyaan_,1,1,1,2,6,0,0.048934752
18599366,hdahne,hdahne,1,1,0,1,6,0,0.048934752
2846936311,mxthad,mxthad,1,1,0,1,6,0,0.048934752
727043545,mekdadabduolah,mekdadabduolah,1,1,0,1,6,0,0.048934752
2413706957,Al_Qiyamah_,Al_Qiyamah_,1,0,1,1,6,0,0
2568146467,htonhton,htonhton,1,1,0,1,6,0,0.048934752
2229685832,rafiali13,rafiali13,1,1,0,1,6,0,0.048934752
18730634,TheDeenShow,TheDeenShow,1,0,1,1,6,0,0
2451033789,Taha_M_M,Taha_M_M,1,1,0,1,6,0,0.048934752
2658029258,ahmedalghazy2,ahmedalghazy2,1,1,0,1,6,0,0.048934752
2286341841,CekicHicranz,CekicHicranz,1,1,0,1,6,0,0.048934752
2149895891,KmaxamedKamal,KmaxamedKamal,1,1,0,1,6,0,0.048934752
409390834,A_ALMUQBIL,A_ALMUQBIL,1,0,1,1,6,0,0
2189801433,AlMaghrebiatu,AlMaghrebiatu,1,0,1,1,6,0,0
2724089644,tubiron65,tubiron65,1,1,0,1,6,0,0.048934752
2466041652,AlHaqAlg1,AlHaqAlg1,1,1,0,1,6,0,0.048934752
2663075733,khilafah_tweet,khilafah_tweet,1,1,0,1,6,0,0.048934752
1470123990,AbouHanief,AbouHanief,1,1,0,1,6,0,0.048934752
2861977562,MountainMan1111,MountainMan1111,1,1,0,1,6,0,0.048934752
65884132,kahmad01,kahmad01,1,1,0,1,6,0,0.048934752
2766262245,MoezJihadi,MoezJihadi,1,1,0,1,6,0,0.048934752
2695745520,abutalha7777777,abutalha7777777,1,1,0,1,6,0,0.048934752
242765819,almohisni,almohisni,1,0,1,1,6,0,0
2733592575,mjhdirak,mjhdirak,1,1,0,1,6,0,0.048934752
17387561,AbdelRahmanM,AbdelRahmanM,1,0,1,1,6,0,0
2489700420,khadijah_1803,khadijah_1803,1,1,0,1,6,0,0.048934752
2573094984,KhadijaMujahida,KhadijaMujahida,1,1,1,2,6,0,0.048934752
2759708752,Vanstein777,Vanstein777,1,1,0,1,6,0,0.048934752
298602588,Free_Media_Hub,Free_Media_Hub,1,0,1,1,6,0,0
2738114674,andeemanya,andeemanya,1,1,0,1,6,0,0.048934752
2753187969,khanv124,khanv124,1,1,0,1,6,0,0.048934752
2544128155,BrandLee5,BrandLee5,1,1,0,1,6,0,0.048934752
535023789,Sword2_of_Allah,Sword2_of_Allah,1,0,1,1,6,0,0
1431457976,ebujunayd,ebujunayd,1,1,0,1,6,0,0.048934752
1396035812,abdullah223345,abdullah223345,1,1,0,1,6,0,0.048934752
1054167320,Khizarulz,Khizarulz,1,1,0,1,6,0,0.048934752
2642006380,mostaf2222,mostaf2222,1,1,0,1,6,0,0.048934752
471454062,FaheemHus,FaheemHus,1,0,1,1,6,0,0
16273804,strabane,strabane,1,1,0,1,6,0,0.048934752
54645160,DARPA,DARPA,1,0,1,1,6,0,0
2761576880,JayshMuhammed,JayshMuhammed,1,1,0,1,6,0,0.048934752
43602362,stephsmth,stephsmth,1,1,0,1,6,0,0.048934752
2716783082,Abdelsalaf,Abdelsalaf,1,1,0,1,6,0,0.048934752
11686412,ahsanullah,ahsanullah,1,0,1,1,6,0,0
302699051,Alien_D00de,Alien_D00de,1,1,0,1,6,0,0.048934752
337007151,ToneLazzaro,ToneLazzaro,1,1,0,1,6,0,0.048934752
1366020666,Shakee93,Shakee93,1,1,0,1,6,0,0.048934752
2729988684,EAbderahi,EAbderahi,1,1,0,1,6,0,0.048934752
2604421726,AchoucAhmed,AchoucAhmed,1,1,0,1,6,0,0.048934752
115561066,SingaSendirian9,SingaSendirian9,1,1,0,1,6,0,0.048934752
2481902188,Umm_Unays,Umm_Unays,1,1,1,2,6,0,0.048934752
1460642580,hanzala_shah,hanzala_shah,1,1,0,1,6,0,0.048934752
1426215552,NabilAwadhy,NabilAwadhy,1,0,1,1,6,0,0
2747683486,luqman059,luqman059,1,1,0,1,6,0,0.048934752
2613334705,aminul46,aminul46,1,1,0,1,6,0,0.048934752
2591220511,zulkefliomar76,zulkefliomar76,1,1,0,1,6,0,0.048934752
1856688858,mist3y,mist3y,1,1,0,1,6,0,0.048934752
2617496329,DawnOfKhilafah,DawnOfKhilafah,1,1,0,1,6,0,0.048934752
2654851909,Kayzer_Sozeh,Kayzer_Sozeh,1,1,0,1,6,0,0.048934752
142691813,shanabdulrehman,shanabdulrehman,1,1,0,1,6,0,0.048934752
2491700138,KhadijaBeauty94,KhadijaBeauty94,1,1,0,1,6,0,0.048934752
98292657,arungenre,arungenre,1,1,0,1,6,0,0.048934752
1214075828,iheartalcohol,iheartalcohol,1,1,0,1,6,0,0.048934752
2826556385,humar_kamel,humar_kamel,1,1,0,1,6,0,0.048934752
2779010022,devletislamiye,devletislamiye,1,1,0,1,6,0,0.048934752
43504696,sajidsibhai,sajidsibhai,1,1,0,1,6,0,0.048934752
2718159931,ssaare_ha,ssaare_ha,1,1,0,1,6,0,0.048934752
2158613570,NordhausenFrank,NordhausenFrank,1,1,0,1,6,0,0.048934752
2654786627,BintTuraab,BintTuraab,1,1,0,1,6,0,0.048934752
2563167306,esved631,esved631,1,1,0,1,6,0,0.048934752
1074254934,ncvkwt,ncvkwt,1,0,1,1,6,0,0
2515351740,Cappucinodrink,Cappucinodrink,1,1,0,1,6,0,0.048934752
254727295,Arab_Fury,Arab_Fury,1,0,1,1,6,0,0
2487571586,khilafah_kmr,khilafah_kmr,1,0,1,1,6,0,0
56054930,marcroehlig,marcroehlig,1,1,0,1,6,0,0.048934752
396288884,ClearAli,ClearAli,1,1,0,1,6,0,0.048934752
59233473,TheIslamicUmmah,TheIslamicUmmah,1,0,1,1,6,0,0
2280379639,ihajar_fr,ihajar_fr,1,1,0,1,6,0,0.048934752
2749027579,m_isis_love,m_isis_love,1,1,0,1,6,0,0.048934752
271890651,AdnanAlarour,AdnanAlarour,1,0,1,1,6,0,0
332780850,dr_alghfaily,dr_alghfaily,1,0,1,1,6,0,0
14996800,rzbh,rzbh,1,1,0,1,6,0,0.048934752
1645827415,r_aminplanner,r_aminplanner,1,1,0,1,6,0,0.048934752
2179650939,AAmriki,AAmriki,1,0,1,1,6,0,0
2529318290,MadiTarekk22,MadiTarekk22,1,1,0,1,6,0,0.048934752
245814713,madnurn,madnurn,1,1,0,1,6,0,0.048934752
148362685,z_a_siddiqui,z_a_siddiqui,1,1,0,1,6,0,0.048934752
2702071266,Caliphate_Satet,Caliphate_Satet,1,1,0,1,6,0,0.048934752
2694436370,SAAD______SAAD,SAAD______SAAD,1,1,0,1,6,0,0.048934752
1557679706,pakda_warrior,pakda_warrior,1,1,0,1,6,0,0.048934752
2396739103,ShaamAlGharib,ShaamAlGharib,1,0,1,1,6,0,0
2853688874,nbinsamat,nbinsamat,1,1,0,1,6,0,0.048934752
2806765110,raziyabegam123,raziyabegam123,1,1,0,1,6,0,0.048934752
993613405,Becca__1985,Becca__1985,1,1,0,1,6,0,0.048934752
2729971308,yaseenraj1,yaseenraj1,1,1,0,1,6,0,0.048934752
248403666,dr_almuqbil,dr_almuqbil,1,0,1,1,6,0,0
943118052,shariah4pak,shariah4pak,1,0,1,1,6,0,0
2700728070,SdShabier,SdShabier,1,1,0,1,6,0,0.048934752
421648141,Lwara_san,Lwara_san,1,1,0,1,6,0,0.048934752
843470616,Waleeeeed35,Waleeeeed35,1,1,0,1,6,0,0.048934752
562059099,R_Pach,R_Pach,1,1,0,1,6,0,0.048934752
484333419,herreraj5640,herreraj5640,1,1,0,1,6,0,0.048934752
2631292805,Abuuthmaan1988,Abuuthmaan1988,1,1,1,2,6,0,0.048934752
2601375644,SharfulAwwal,SharfulAwwal,1,1,0,1,6,0,0.048934752
1962432463,AtherFarrukh,AtherFarrukh,1,1,1,2,6,0,0.048934752
2647873496,FirstDin,FirstDin,1,1,0,1,6,0,0.048934752
349624385,Dawah2024,Dawah2024,1,1,1,2,6,0,0.048934752
740808794,SyrianSupport,SyrianSupport,1,0,1,1,6,0,0
2600786020,umqitaal,umqitaal,1,1,0,1,6,0,0.048934752
2667436160,HarunMoussa,HarunMoussa,1,1,0,1,6,0,0.048934752
2726880289,EzadMetzz,EzadMetzz,1,1,0,1,6,0,0.048934752
468653182,Brandeh_tajada,Brandeh_tajada,1,1,0,1,6,0,0.048934752
31021351,Thomas_Short87,Thomas_Short87,1,1,0,1,6,0,0.048934752
1310611790,bobbergdahl,bobbergdahl,1,0,1,1,6,0,0
2471355450,MuazTurk,MuazTurk,1,1,0,1,6,0,0.048934752
1692064099,Aboud5Rogo,Aboud5Rogo,1,1,0,1,6,0,0.048934752
2715408750,hoodh0909,hoodh0909,1,1,0,1,6,0,0.048934752
2776160646,aff20061,aff20061,1,1,0,1,6,0,0.048934752
1933662602,mokhtarsodani,mokhtarsodani,1,1,0,1,6,0,0.048934752
2839042644,saqib112233,saqib112233,1,1,0,1,6,0,0.048934752
2692176469,abdizak071,abdizak071,1,1,0,1,6,0,0.048934752
2458901088,AbdulRahman1940,AbdulRahman1940,1,1,0,1,6,0,0.048934752
2801195666,hashtagterror,hashtagterror,1,1,0,1,6,0,0.048934752
235592347,sohail_ul_haq,sohail_ul_haq,1,1,1,2,6,0,0.048934752
492133058,HashArabianG,HashArabianG,1,1,0,1,6,0,0.048934752
253614801,altriri,altriri,1,0,1,1,6,0,0
491051734,Azrul02,Azrul02,1,1,0,1,6,0,0.048934752
2575260397,Ali_AlFiransi,Ali_AlFiransi,1,1,0,1,6,0,0.048934752
33839886,djtalha20,djtalha20,1,1,0,1,6,0,0.048934752
2768100151,mohsinkhaann1,mohsinkhaann1,1,1,0,1,6,0,0.048934752
1882970936,yudasoni,yudasoni,1,1,0,1,6,0,0.048934752
2598853435,1Bosnawi1,1Bosnawi1,1,1,0,1,6,0,0.048934752
157834059,Tawheed83,Tawheed83,1,1,0,1,6,0,0.048934752
2731891614,Hassan__Mansoor,Hassan__Mansoor,1,1,0,1,6,0,0.048934752
2830162874,victoryinyahweh,victoryinyahweh,1,1,0,1,6,0,0.048934752
2677365704,SaadMuhajir,SaadMuhajir,1,1,0,1,6,0,0.048934752
25060515,AhmadAlZ,AhmadAlZ,1,1,0,1,6,0,0.048934752
2820135902,ra_umm,ra_umm,1,1,0,1,6,0,0.048934752
2375015466,ShaamPost,ShaamPost,1,0,1,1,6,0,0
2611567688,Ibraalmohajir,Ibraalmohajir,1,1,0,1,6,0,0.048934752
2646596696,abuhamzah1948,abuhamzah1948,1,1,0,1,6,0,0.048934752
265411728,ALSHEHRI89,ALSHEHRI89,1,0,1,1,6,0,0
2602097826,AishaBinte2,AishaBinte2,1,1,0,1,6,0,0.048934752
1226300581,Abuhaniefabe,Abuhaniefabe,1,1,1,2,6,0,0.048934752
9624742,StateDept,StateDept,1,0,1,1,6,0,0
1902173390,AbuBaraaUK,AbuBaraaUK,1,0,1,1,6,0,0
2593217756,eldorado343,eldorado343,1,1,0,1,6,0,0.048934752
1078385935,GHenderman,GHenderman,1,1,0,1,6,0,0.048934752
2620316992,AkowwaA,AkowwaA,1,1,0,1,6,0,0.048934752
2688834882,AbuKhadr_IS,AbuKhadr_IS,1,1,0,1,6,0,0.048934752
2605669711,DaudKhan618,DaudKhan618,1,1,0,1,6,0,0.048934752
2592300414,lawabidincitize,lawabidincitize,1,1,0,1,6,0,0.048934752
372432269,FByusuf10,FByusuf10,1,1,0,1,6,0,0.048934752
15687092,jonasson,jonasson,1,1,0,1,6,0,0.048934752
2176802240,Military_Edge,Military_Edge,1,0,1,1,6,0,0
2542657029,Closetsheep,Closetsheep,1,1,0,1,6,0,0.048934752
2809421347,BintangPemanah,BintangPemanah,1,1,0,1,6,0,0.048934752
2734329782,alshami187,alshami187,1,1,0,1,6,0,0.048934752
2482593409,jihaad4haqq,jihaad4haqq,1,1,1,2,6,0,0.048934752
2556911286,Akh_Abdul00,Akh_Abdul00,1,1,0,1,6,0,0.048934752
26074814,EnriqueJr305,EnriqueJr305,1,1,0,1,6,0,0.048934752
350379740,neeom_Islami,neeom_Islami,1,1,0,1,6,0,0.048934752
2840911592,kambs06,kambs06,1,1,0,1,6,0,0.048934752
630939382,umm_esa73,umm_esa73,1,1,0,1,6,0,0.048934752
2833768198,BIndunisi,BIndunisi,1,1,0,1,6,0,0.048934752
2735988559,WidiaYessi,WidiaYessi,1,1,0,1,6,0,0.048934752
811720586,rattyempyror,rattyempyror,1,1,0,1,6,0,0.048934752
123199505,taseenbhat,taseenbhat,1,3,0,3,6,0.8333333,0.092788046
2650824742,SandiParkman,SandiParkman,1,1,0,1,6,0,0.048934752
2648891449,shooterkhanisis,shooterkhanisis,1,1,0,1,6,0,0.048934752
2791170116,haidarpur,haidarpur,1,0,1,1,6,0,0
454942803,kuwait2012Q8,kuwait2012Q8,1,1,0,1,6,0,0.048934752
1110204535,Terzijaj1,Terzijaj1,1,4,0,4,6,0.8333333,0.157330079
2610913512,69Jihads,69Jihads,1,2,0,2,6,1,0.082326345
2616451311,SaddamDdamsa123,SaddamDdamsa123,1,1,0,1,6,0,0.048934752
2641649927,muhirashid,muhirashid,1,1,0,1,6,0,0.048934752
2658379143,abou_foulaan31,abou_foulaan31,1,1,0,1,6,0,0.048934752
1446568243,almohajdesigner,almohajdesigner,1,1,1,2,6,0,0.048934752
2658066766,bhattsaifullah3,bhattsaifullah3,1,1,0,1,6,0,0.048934752
2757583212,afghani_abu,afghani_abu,1,1,0,1,6,0,0.048934752
2820104576,nayanahmed200,nayanahmed200,1,1,0,1,6,0,0.048934752
2365841802,farooqurmi,farooqurmi,1,1,0,1,6,0,0.048934752
78668240,JannehIbrahima,JannehIbrahima,1,1,0,1,6,0,0.048934752
2616840272,akbar0216,akbar0216,1,1,0,1,6,0,0.048934752
2754312955,tabi_akhbar,tabi_akhbar,1,1,0,1,6,0,0.048934752
2625036777,IbnYahya30,IbnYahya30,1,1,0,1,6,0,0.048934752
1491755498,OccupiedTaksim,OccupiedTaksim,1,1,0,1,6,0,0.048934752
543412308,madheehu,madheehu,1,1,0,1,6,0,0.048934752
1539892664,iStriv3r,iStriv3r,1,1,0,1,6,0,0.048934752
27222636,unseenfootage,unseenfootage,1,0,1,1,6,0,0
2506908275,DualeMohamud,DualeMohamud,1,1,0,1,6,0,0.048934752
2748867221,jannah_deen,jannah_deen,1,2,0,2,6,1,0.082326345
2833408706,Nexuz8S,Nexuz8S,1,1,0,1,6,0,0.048934752
1105420999,J0HNMcTERNAN,J0HNMcTERNAN,1,1,0,1,6,0,0.048934752
2603115224,MetM5,MetM5,1,1,0,1,6,0,0.048934752
62218972,LilXiiwii,LilXiiwii,1,1,0,1,6,0,0.048934752
2820530912,abdbaset4,abdbaset4,1,1,0,1,6,0,0.048934752
2213733145,hmhamas,hmhamas,1,2,0,2,6,1,0.073645766
2719408973,hmuJaheed1,hmuJaheed1,1,1,0,1,6,0,0.048934752
2420269904,Dee_Amatullah,Dee_Amatullah,1,1,0,1,6,0,0.048934752
995451746,rudol9h,rudol9h,1,0,1,1,6,0,0
776528756,omarsuleiman504,omarsuleiman504,1,0,1,1,6,0,0
2576507805,isismszr1,isismszr1,1,2,0,2,6,0.5,0.059760868
334193566,dmw363,dmw363,1,1,0,1,6,0,0.048934752
2777441224,ShaheedaUmm,ShaheedaUmm,1,1,0,1,6,0,0.048934752
1578066894,SadiaAyazi,SadiaAyazi,1,1,0,1,6,0,0.048934752
875979728,sayyedkotb1906,sayyedkotb1906,1,1,0,1,6,0,0.048934752
709190610,_HadithoftheDay,_HadithoftheDay,1,0,1,1,6,0,0
885351386,bukharisigat,bukharisigat,1,1,0,1,6,0,0.048934752
2747032614,minskype57,minskype57,1,2,0,2,6,0.5,0.059396452
2519917614,JihadiMemes,JihadiMemes,1,0,1,1,6,0,0
93971510,adamamirsmith,adamamirsmith,1,1,1,2,6,0,0.048934752
155903049,iERAorg,iERAorg,1,0,1,1,6,0,0
75293774,amberinzaman,amberinzaman,1,1,0,1,6,0,0.048934752
1465476205,KIZARK15,KIZARK15,1,2,0,2,6,1,0.073645766
27059347,AJEVideos,AJEVideos,1,0,1,1,6,0,0
2809505311,AhmadRouleau,AhmadRouleau,1,1,0,1,6,0,0.048934752
2708792524,1985Waqar,1985Waqar,1,1,0,1,6,0,0.048934752
2838619370,7Wahabe121R,7Wahabe121R,1,1,0,1,6,0,0.048934752
2770199787,magomedaliev381,magomedaliev381,1,1,0,1,6,0,0.048934752
1340302603,MiahMansoor,MiahMansoor,1,1,1,2,6,0,0.048934752
2289165582,birruni_al,birruni_al,1,1,0,1,6,0,0.048934752
2734253358,ah2salim,ah2salim,1,1,0,1,6,0,0.048934752
2564624612,tawhidnjihad,tawhidnjihad,1,1,0,1,6,0,0.048934752
2662458714,AbuBakr_Shami,AbuBakr_Shami,1,2,0,2,6,1,0.082326345
1653892446,Abuisaalgareeb,Abuisaalgareeb,1,1,0,1,6,0,0.048934752
1574036893,AbeMoussa,AbeMoussa,1,1,1,2,6,0,0.048934752
2678285743,HamzaBeg,HamzaBeg,1,1,0,1,6,0,0.048934752
2512971222,AfricaMusIIma,AfricaMusIIma,1,0,1,1,6,0,0
2714265060,aussiecrusader,aussiecrusader,1,1,0,1,6,0,0.048934752
37643762,jamspoon1965,jamspoon1965,1,1,0,1,6,0,0.048934752
2347492883,AbuKhalid0304,AbuKhalid0304,1,0,1,1,6,0,0
1416128052,abo_abo1433,abo_abo1433,1,1,1,2,6,0,0.048934752
2853922424,AliahAsiyah,AliahAsiyah,1,1,0,1,6,0,0.048934752
2214749832,AGMartinez888,AGMartinez888,1,1,0,1,6,0,0.048934752
2519361182,H_SHEMRANI83,H_SHEMRANI83,1,1,0,1,6,0,0.048934752
2712364726,khanzabi8881,khanzabi8881,1,1,0,1,6,0,0.048934752
562816696,syedtajamul27,syedtajamul27,1,1,0,1,6,0,0.048934752
2799691496,rawwaha,rawwaha,1,1,0,1,6,0,0.048934752
2745329397,fiekiesamsodien,fiekiesamsodien,1,2,0,2,6,1,0.082326345
782728148,UmmMariam84,UmmMariam84,1,1,0,1,6,0,0.048934752
2228545276,OmarKhattabHaru,OmarKhattabHaru,1,1,0,1,6,0,0.048934752
2544035618,AbuTalha001,AbuTalha001,1,484,2176,2660,6,5.07E-04,1
2737333895,shariaislametat,shariaislametat,1,1,0,1,6,0,0.048934752
460809866,moin_kharal,moin_kharal,1,1,0,1,6,0,0.048934752
2838488899,mcxxg22,mcxxg22,1,1,0,1,6,0,0.048934752
2508187508,1M_1VOICE,1M_1VOICE,1,0,1,1,6,0,0
2264754062,zuharoses,zuharoses,1,1,0,1,6,0,0.048934752
2564506007,dawlah_izzah,dawlah_izzah,1,1,0,1,6,0,0.048934752
307390449,PengkhianatPYTM,PengkhianatPYTM,1,1,0,1,6,0,0.048934752
8775672,USArmy,USArmy,1,0,1,1,6,0,0
2496090452,ivanov6548,ivanov6548,1,1,0,1,6,0,0.048934752
1582884890,Yoursahiby,Yoursahiby,1,1,0,1,6,0,0.048934752
2695325737,tawheedalhindi,tawheedalhindi,1,1,0,1,6,0,0.048934752
125921386,mf0692,mf0692,1,2,0,2,6,1,0.082326345
2421155957,Abououssamahf,Abououssamahf,1,1,0,1,6,0,0.048934752
2686216320,UmmUmmayah,UmmUmmayah,1,1,0,1,6,0,0.048934752
2768267393,RaufSevim,RaufSevim,1,1,0,1,6,0,0.048934752
2521032853,CrushOurEnemies,CrushOurEnemies,1,1,0,1,6,0,0.048934752
2721966293,clgeee,clgeee,1,1,0,1,6,0,0.048934752
298029434,faizaminmalayzi,faizaminmalayzi,1,1,0,1,6,0,0.048934752
887110711,khannasir40,khannasir40,1,1,0,1,6,0,0.048934752
842000718,abuhafs2012,abuhafs2012,1,0,1,1,6,0,0
2838292831,Hadeed_007,Hadeed_007,1,1,0,1,6,0,0.048934752
1169582444,salahudeen2013,salahudeen2013,1,1,0,1,6,0,0.048934752
1673947524,UK2Syria,UK2Syria,1,0,1,1,6,0,0
2516314554,NamorMcKenzie2,NamorMcKenzie2,1,1,0,1,6,0,0.048934752
14214901,fxy,fxy,1,1,0,1,6,0,0.048934752
2312759789,faddeii,faddeii,1,1,0,1,6,0,0.048934752
2482465280,AbuAbdullaahAS,AbuAbdullaahAS,1,0,1,1,6,0,0
2713578002,mustafasiddq,mustafasiddq,1,1,0,1,6,0,0.048934752
2770299424,ummkhaira,ummkhaira,1,2,0,2,6,0.5,0.052704998
1012034179,LylouArabya,LylouArabya,1,2,0,2,6,0.5,0.059396452
2603547758,AbuHuseyn1,AbuHuseyn1,1,1,0,1,6,0,0.048934752
1251125017,JehnaJehan,JehnaJehan,1,1,0,1,6,0,0.048934752
592538267,fabio_delfrate,fabio_delfrate,1,1,0,1,6,0,0.048934752
2389011134,roslan_hussien,roslan_hussien,1,1,0,1,6,0,0.048934752
289893104,MahmoudAlves,MahmoudAlves,1,1,0,1,6,0,0.048934752
2727439835,NakrebN,NakrebN,1,1,0,1,6,0,0.048934752
2828626782,jund_reporter,jund_reporter,1,0,1,1,6,0,0
2781014880,MohdBrown,MohdBrown,1,1,0,1,6,0,0.048934752
263777138,AsSuffa,AsSuffa,1,0,1,1,6,0,0
1218145214,adoubu,adoubu,1,1,0,1,6,0,0.048934752
2805263318,Abumarium1,Abumarium1,1,2,0,2,6,1,0.082326345
2779180000,UAlmujahideen,UAlmujahideen,1,1,0,1,6,0,0.048934752
2795465775,ummsalama15_,ummsalama15_,1,2,0,2,6,1,0.073645766
2736493064,guecata,guecata,1,1,0,1,6,0,0.048934752
435743804,Moterrorist1,Moterrorist1,1,1,0,1,6,0,0.048934752
2602986624,Abu_Sulayman911,Abu_Sulayman911,1,1,0,1,6,0,0.048934752
2171038853,khancentral,khancentral,1,1,0,1,6,0,0.048934752
2163633313,AhmadMu41766797,AhmadMu41766797,1,1,0,1,6,0,0.048934752
1520331938,abubakralamriki,abubakralamriki,1,1,1,2,6,0,0.048934752
2483088547,MehdiTunisi1,MehdiTunisi1,1,1,0,1,6,0,0.048934752
2745035947,salahudinalswed,salahudinalswed,1,1,0,1,6,0,0.048934752
2734679924,AbdullahtheBean,AbdullahtheBean,1,1,0,1,6,0,0.048934752
2771283238,AbuJibrilShaam,AbuJibrilShaam,1,1,0,1,6,0,0.048934752
2723802420,dian_ayu88,dian_ayu88,1,1,1,2,6,0,0.048934752
1627811210,hashime21,hashime21,1,3,0,3,6,0.33333334,0.063166699
469560762,Iftakhar_dr,Iftakhar_dr,1,1,0,1,6,0,0.048934752
2396188112,4nonymou5_one,4nonymou5_one,1,1,0,1,6,0,0.048934752
2604985893,niketsat34,niketsat34,1,1,0,1,6,0,0.048934752
2808213067,wvjasonc,wvjasonc,1,1,0,1,6,0,0.048934752
781741644,ananda40304706,ananda40304706,1,1,0,1,6,0,0.048934752
2735369812,said_turki_1,said_turki_1,1,1,0,1,6,0,0.048934752
2379705974,1539647360,1539647360,1,1,0,1,6,0,0.048934752
2450943644,muslimahmslm,muslimahmslm,1,1,0,1,6,0,0.048934752
2687889108,muusliimaah,muusliimaah,1,1,0,1,6,0,0.048934752
2579197687,muhamma_waseemm,muhamma_waseemm,1,1,0,1,6,0,0.048934752
2722033476,abuanwar2006,abuanwar2006,1,1,0,1,6,0,0.048934752
2696769396,EissaYunus,EissaYunus,1,1,0,1,6,0,0.048934752
2247126912,Majidf2829,Majidf2829,1,1,0,1,6,0,0.048934752
2625007511,Firdaws_911,Firdaws_911,1,1,0,1,6,0,0.048934752
2668969291,alrashidk11,alrashidk11,1,1,0,1,6,0,0.048934752
2295099354,stone_zack1,stone_zack1,1,1,0,1,6,0,0.048934752
2780772132,ShlomoArigato,ShlomoArigato,1,1,0,1,6,0,0.048934752
2512257024,jalel20141,jalel20141,1,1,0,1,6,0,0.048934752
2267213854,baaaqiyah,baaaqiyah,1,0,2,2,6,1,0
857894958,786Sazzy,786Sazzy,1,0,1,1,6,0,0
22343828,koehorst,koehorst,1,1,0,1,6,0,0.048934752
2825154710,franktank901,franktank901,1,2,0,2,6,0.5,0.052704998
2797564100,20540881,20540881,1,1,0,1,6,0,0.048934752
2519593229,WizzeDom01,WizzeDom01,1,1,0,1,6,0,0.048934752
2555084173,AbuHambali,AbuHambali,1,1,0,1,6,0,0.048934752
47870298,urbanfarme,urbanfarme,1,1,0,1,6,0,0.048934752
449605985,Bi_idhnih,Bi_idhnih,1,1,0,1,6,0,0.048934752
2752704900,asiaalwn17,asiaalwn17,1,1,0,1,6,0,0.048934752
407302540,Dan_long_1,Dan_long_1,1,1,0,1,6,0,0.048934752
299889054,KhilafahYouth,KhilafahYouth,1,0,1,1,6,0,0
550105523,muhammedifaz,muhammedifaz,1,1,0,1,6,0,0.048934752
2807361987,BakerBahgdadi,BakerBahgdadi,1,1,0,1,6,0,0.048934752
2794776654,ALDjazairi2,ALDjazairi2,1,2,0,2,6,1,0.082326345
2655777279,sayfullah2014,sayfullah2014,1,0,1,1,6,0,0
2771776024,AMaqdad,AMaqdad,1,1,0,1,6,0,0.048934752
2199253549,jezia13,jezia13,1,2,0,2,6,1,0.082326345
2787963451,PlanetWitness,PlanetWitness,1,1,0,1,6,0,0.048934752
440330336,huriwa,huriwa,1,1,0,1,6,0,0.048934752
2300047946,SalmanAlfarsi_,SalmanAlfarsi_,1,0,1,1,6,0,0
2425320014,UmmuAsadullah,UmmuAsadullah,1,1,0,1,6,0,0.048934752
2608296554,KosherRed,KosherRed,1,1,0,1,6,0,0.048934752
1125085818,An0nymxus,An0nymxus,1,1,0,1,6,0,0.048934752
2782586986,TauhidTeam,TauhidTeam,1,1,0,1,6,0,0.048934752
594997907,wisedumbguy,wisedumbguy,1,1,0,1,6,0,0.048934752
157280366,MIPanhwar,MIPanhwar,1,1,0,1,6,0,0.048934752
399340291,Kashif2610,Kashif2610,1,1,0,1,6,0,0.048934752
2394813270,hollyquraan2,hollyquraan2,1,1,0,1,6,0,0.048934752
2754409321,princeabz123,princeabz123,1,1,0,1,6,0,0.048934752
787944254,muslimpearls,muslimpearls,1,1,0,1,6,0,0.048934752
50525209,abooo786,abooo786,1,1,0,1,6,0,0.048934752
534148125,shoaibrather99,shoaibrather99,1,1,0,1,6,0,0.048934752
2717021215,HibaLbsalat,HibaLbsalat,1,1,0,1,6,0,0.048934752
2701554732,puti_mach,puti_mach,1,1,0,1,6,0,0.048934752
2742364338,AhmedLibi2,AhmedLibi2,1,1,0,1,6,0,0.048934752
2766500982,tacbir05,tacbir05,1,2,0,2,6,0.5,0.059396452
1486779553,munawwarahmael,munawwarahmael,1,1,0,1,6,0,0.048934752
316568744,itszak88,itszak88,1,1,1,2,6,0,0.048934752
561804460,nazeerahmedjun1,nazeerahmedjun1,1,2,0,2,6,0.5,0.052704998
393278755,mahernour80,mahernour80,1,1,0,1,6,0,0.048934752
1084192039,Khalid_Maqdisi,Khalid_Maqdisi,1,2,5,7,6,0.8,0.035172715
1318188332,yesuph,yesuph,1,1,0,1,6,0,0.048934752
1736209717,frsyru,frsyru,1,1,0,1,6,0,0.048934752
831583560,Liaqat1Ali,Liaqat1Ali,1,1,0,1,6,0,0.048934752
96335276,abinayla,abinayla,1,2,0,2,6,0.5,0.052704998
2560980404,abuyassir63,abuyassir63,1,1,0,1,6,0,0.048934752
112653778,vio_lin66,vio_lin66,1,1,0,1,6,0,0.048934752
1556215286,sema0201,sema0201,1,1,0,1,6,0,0.048934752
2805954060,muhammadxalid1,muhammadxalid1,1,1,0,1,6,0,0.048934752
99281157,sanoopum,sanoopum,1,1,0,1,6,0,0.048934752
580613672,ziabinkhalik,ziabinkhalik,1,1,0,1,6,0,0.048934752
166032959,laodea,laodea,1,1,0,1,6,0,0.048934752
2577888866,TugauMaharaja,TugauMaharaja,1,1,0,1,6,0,0.048934752
2822993529,mustafaameri10,mustafaameri10,1,1,0,1,6,0,0.048934752
1861088906,Truthlives_in4D,Truthlives_in4D,1,1,0,1,6,0,0.048934752
1442772648,jaffa20092009,jaffa20092009,1,1,0,1,6,0,0.048934752
2325313249,FurqanH00700,FurqanH00700,1,1,0,1,6,0,0.048934752
17266402,farhantahir,farhantahir,1,1,0,1,6,0,0.048934752
2760767229,hidaya0309213,hidaya0309213,1,1,0,1,6,0,0.048934752
2662004493,jaay238,jaay238,1,1,0,1,6,0,0.048934752
373290767,MAhmadOsama,MAhmadOsama,1,1,1,2,6,0,0.048934752
384497439,cano1970,cano1970,1,1,0,1,6,0,0.048934752
2434967856,DertliAnne,DertliAnne,1,1,0,1,6,0,0.048934752
2649519906,AbouTouchant,AbouTouchant,1,1,0,1,6,0,0.048934752
472017211,agitswm,agitswm,1,1,0,1,6,0,0.048934752
2756212607,M_i_n_u,M_i_n_u,1,1,0,1,6,0,0.048934752
1721235342,umairs1996,umairs1996,1,0,1,1,6,0,0
780007321,NaseemSadak,NaseemSadak,1,1,0,1,6,0,0.048934752
2800547756,chinaman1981,chinaman1981,1,1,0,1,6,0,0.048934752
1974794186,Ahmed__Hussain_,Ahmed__Hussain_,1,0,1,1,6,0,0
2162441890,kat16230,kat16230,1,1,0,1,6,0,0.048934752
1650161630,ebuhafsturk,ebuhafsturk,1,0,1,1,6,0,0
1738930196,khalideena1,khalideena1,1,1,0,1,6,0,0.048934752
2664036375,MuksiniI,MuksiniI,1,1,0,1,6,0,0.048934752
97482781,flashking,flashking,1,1,0,1,6,0,0.048934752
2301687952,simpsonsmg,simpsonsmg,1,1,0,1,6,0,0.048934752
49346724,Handsome_Johnny,Handsome_Johnny,1,1,0,1,6,0,0.048934752
2614982847,teymiyye00,teymiyye00,1,1,0,1,6,0,0.048934752
21362977,janetreitman,janetreitman,1,1,0,1,6,0,0.048934752
220494176,fabianfarias1,fabianfarias1,1,1,0,1,6,0,0.048934752
2762271122,hulubalang_jaiz,hulubalang_jaiz,1,1,0,1,6,0,0.048934752
2175826333,ALFARUUQMEDIA,ALFARUUQMEDIA,1,1,0,1,6,0,0.048934752
35289523,tanyasaintclair,tanyasaintclair,1,1,0,1,6,0,0.048934752
2795927989,lionesszofallah,lionesszofallah,1,1,0,1,6,0,0.048934752
422935027,khatijal,khatijal,1,1,0,1,6,0,0.048934752
186743311,tiopecellele,tiopecellele,1,1,0,1,6,0,0.048934752
17267235,atiquemanda,atiquemanda,1,1,0,1,6,0,0.048934752
2586212900,ak_english,ak_english,1,1,0,1,6,0,0.048934752
592149039,muri33forza,muri33forza,1,1,0,1,6,0,0.048934752
2768370226,chamanitinda,chamanitinda,1,1,0,1,6,0,0.048934752
2847472214,EyachinH,EyachinH,1,1,0,1,6,0,0.048934752
2681928283,aftabazmi80,aftabazmi80,1,1,0,1,6,0,0.048934752
2654010007,abou_jouwayriya,abou_jouwayriya,1,1,0,1,6,0,0.048934752
2836953781,DAWLAPHOTOS,DAWLAPHOTOS,1,1,0,1,6,0,0.048934752
2778626753,hgtgsyb,hgtgsyb,1,1,0,1,6,0,0.048934752
2758769384,hurairah033,hurairah033,1,1,0,1,6,0,0.048934752
2849766170,jundofallah,jundofallah,1,1,0,1,6,0,0.048934752
2671147860,kenyanwitness,kenyanwitness,1,1,0,1,6,0,0.048934752
2726525792,hackerthone,hackerthone,1,1,0,1,6,0,0.048934752
2790194017,arslanhadikpt71,arslanhadikpt71,1,1,0,1,6,0,0.048934752
2342353778,18Sungur,18Sungur,1,1,0,1,6,0,0.048934752
2753657762,immish98,immish98,1,1,0,1,6,0,0.048934752
2568649662,pkabubakar8,pkabubakar8,1,1,0,1,6,0,0.048934752
472513476,Abu_Nuh92,Abu_Nuh92,1,1,0,1,6,0,0.048934752
549256171,rusianjanuary,rusianjanuary,1,1,0,1,6,0,0.048934752
2331048962,xhudeen,xhudeen,1,1,0,1,6,0,0.048934752
54885400,USNavy,USNavy,1,0,1,1,6,0,0
1053354504,kp_rohling,kp_rohling,1,1,0,1,6,0,0.048934752
2608364605,saiful7900,saiful7900,1,1,0,1,6,0,0.048934752
2645752914,UmmSirine,UmmSirine,1,2,0,2,6,0.5,0.059396452
2204826734,Islamarmy_EN,Islamarmy_EN,1,0,1,1,6,0,0
2177662139,kabuhafs,kabuhafs,1,1,1,2,6,0,0.048934752
83590349,bencnn,bencnn,1,1,0,1,6,0,0.048934752
94600417,FAIZALTHEYAMAHA,FAIZALTHEYAMAHA,1,1,0,1,6,0,0.048934752
242051629,Mufti_Muhammad_,Mufti_Muhammad_,1,0,1,1,6,0,0
2617670928,Zamanulkhilafah,Zamanulkhilafah,1,1,0,1,6,0,0.048934752
2721709339,javidahmedbhat2,javidahmedbhat2,1,1,0,1,6,0,0.048934752
2258042241,RamoGull,RamoGull,1,1,0,1,6,0,0.048934752
1012629398,azaman78,azaman78,1,1,0,1,6,0,0.048934752
2691923334,noor_nmohd959,noor_nmohd959,1,1,0,1,6,0,0.048934752
2574155187,TrackedMuslim,TrackedMuslim,1,1,0,1,6,0,0.048934752
2349159674,is55aa,is55aa,1,1,0,1,6,0,0.048934752
154148292,ahm3dMSQ,ahm3dMSQ,1,1,0,1,6,0,0.048934752
21298696,OliviaAlabaster,OliviaAlabaster,1,1,0,1,6,0,0.048934752
785964,m_usmanayub,m_usmanayub,1,1,1,2,6,0,0.048934752
2786786956,UsayrimL,UsayrimL,1,1,0,1,6,0,0.048934752
2512158362,thaeralshamy,thaeralshamy,1,1,0,1,6,0,0.048934752
1153236643,IslamRevlution,IslamRevlution,1,0,1,1,6,0,0
585629353,mohamed_altheeb,mohamed_altheeb,1,0,1,1,6,0,0
2615672540,dougy4321,dougy4321,1,1,0,1,6,0,0.048934752
519569139,KhaledAbuToameh,KhaledAbuToameh,1,0,1,1,6,0,0
35454721,hizbuttahrir,hizbuttahrir,1,0,1,1,6,0,0
2829614858,Babu1820,Babu1820,1,1,0,1,6,0,0.048934752
342949662,AbduraheemGreen,AbduraheemGreen,1,0,1,1,6,0,0
2781491316,TonyPointcook,TonyPointcook,1,1,0,1,6,0,0.048934752
2563626290,MohammedRimaaz,MohammedRimaaz,1,1,0,1,6,0,0.048934752
2571468601,salahuddinalay,salahuddinalay,1,1,0,1,6,0,0.048934752
947224388,ECLSN10,ECLSN10,1,1,0,1,6,0,0.048934752
964493132,halemenal,halemenal,1,1,0,1,6,0,0.048934752
2803760977,abul17475113,abul17475113,1,1,0,1,6,0,0.048934752
2423029604,Abudujanahusama,Abudujanahusama,1,0,1,1,6,0,0
2336423837,heinzthogersen,heinzthogersen,1,1,0,1,6,0,0.048934752
1850933185,Omar_salafi,Omar_salafi,1,1,0,1,6,0,0.048934752
2746548195,AbuTejma,AbuTejma,1,1,0,1,6,0,0.048934752
18120690,abdulbary,abdulbary,1,0,1,1,6,0,0
